ínàÊÉRÅ[Éh,ìsìπï{åß,ésãÊí¨ë∫,ëçêlå˚,ëçêlå˚ÅiíjÅj,ëçêlå˚ÅièóÅj,ì˙ñ{êlêlå˚,ì˙ñ{êlêlå˚ÅiíjÅj,ì˙ñ{êlêlå˚ÅièóÅj,15çŒñ¢ñûêlå˚,15çŒñ¢ñûêlå˚ÅiíjÅj,15çŒñ¢ñûêlå˚ÅièóÅj,15Å`64çŒêlå˚,15Å`64çŒêlå˚ÅiíjÅj,15Å`64çŒêlå˚ÅièóÅj,65çŒà»è„êlå˚,65çŒà»è„êlå˚ÅiíjÅj,65çŒà»è„êlå˚ÅièóÅj,75çŒà»è„êlå˚,75çŒà»è„êlå˚ÅiíjÅj,75çŒà»è„êlå˚ÅièóÅj,äOçëêlêlå˚,èoê∂êî,éÄñSêî,àÍî ïaâ@êî,àÍî êfó√èäêî,éïâ»êfó√èäêî,à„étêî,éïâ»à„étêî,ñÚç‹étêî,ï€àÁèäìôêîÅiäÓñ{ï[Åj
R01100,ñkäCìπ,éDñyés,1973395,918682,1054713,1933094,897727,1035367,215366,110196,105170,1185724,566874,618850,541242,224966,316276,264920,98452,166468,12634,12259,20261,178,1375,1205,6978,2142,5758,343
R01202,ñkäCìπ,îüäŸés,251084,113965,137119,248208,112718,135490,23560,11984,11576,134953,64971,69982,89257,35342,53915,45963,16118,29845,989,1231,3827,26,207,126,822,182,683,53
R01203,ñkäCìπ,è¨íMés,111299,50136,61163,109971,49441,60530,9169,4678,4491,55643,26790,28853,45426,18009,27417,24086,8559,15527,552,425,1932,11,80,78,338,105,334,23
R01204,ñkäCìπ,àÆêÏés,329306,152108,177198,325287,150318,174969,34691,17797,16894,178060,85575,92485,112411,46768,65643,58032,22143,35889,1082,1913,4617,36,225,171,1364,246,876,71
R01205,ñkäCìπ,é∫óñés,82383,40390,41993,81658,39960,41698,7769,3916,3853,43398,23259,20139,30330,12565,17765,16418,6265,10153,380,421,1236,6,52,40,249,56,193,11
R01206,ñkäCìπ,ã˙òHés,165077,77506,87571,163026,76789,86237,16634,8495,8139,90595,44886,45709,56355,23465,32890,28354,10823,17531,815,863,2271,15,78,85,379,107,374,26
R01207,ñkäCìπ,ë—çLés,166536,79623,86913,165759,79211,86548,19073,9762,9311,96804,48097,48707,49000,20616,28384,24870,9548,15322,717,1076,1839,17,110,96,538,145,417,29
R01208,ñkäCìπ,ñkå©és,115480,54729,60751,114601,54346,60255,12014,6170,5844,63217,31713,31504,38841,16230,22611,20031,7673,12358,402,611,1512,12,63,51,234,74,222,27
R01209,ñkäCìπ,ó[í£és,7334,3381,3953,7247,3373,3874,411,199,212,3093,1609,1484,3828,1571,2257,2262,818,1444,87,22,186,0,6,4,7,7,16,3
R01210,ñkäCìπ,ä‚å©ëÚés,79306,37105,42201,79031,36970,42061,7859,3961,3898,42391,21004,21387,28880,12062,16818,15113,5691,9422,196,369,1094,5,58,49,178,67,141,18
R01211,ñkäCìπ,ñ‘ëñés,35759,18060,17699,35429,17962,17467,3731,1932,1799,20405,11042,9363,11259,4818,6441,5595,2198,3397,321,200,427,3,14,15,54,20,53,4
R01212,ñkäCìπ,óØñGés,20114,9649,10465,19940,9610,10330,1711,885,826,9981,5234,4747,7425,3002,4423,3944,1467,2477,134,99,320,2,15,11,48,12,49,3
R01213,ñkäCìπ,ìœè¨ñqés,170113,83522,86591,168873,82739,86134,20426,10593,9833,96847,49324,47523,50022,21637,28385,23635,9242,14393,722,1139,1950,10,89,74,343,110,312,27
R01214,ñkäCìπ,ítì‡és,33563,16651,16912,33083,16509,16574,3484,1806,1678,18920,10016,8904,11025,4739,6286,5458,2105,3353,435,187,448,3,16,11,47,16,52,6
R01215,ñkäCìπ,î¸âSés,20413,9565,10848,20343,9527,10816,1539,813,726,10169,5143,5026,8642,3575,5067,4739,1786,2953,44,64,387,3,11,13,42,16,26,5
R01216,ñkäCìπ,à∞ï és,12555,5762,6793,12536,5758,6778,845,435,410,5705,2854,2851,5995,2464,3531,3412,1304,2108,17,40,280,2,3,8,15,9,22,1
R01217,ñkäCìπ,ç]ï és,121056,57523,63533,119589,56702,62887,13400,6786,6614,69555,34012,35543,36783,15876,20907,18112,7027,11085,635,638,1265,5,69,64,167,89,194,18
R01218,ñkäCìπ,ê‘ïΩés,9698,4388,5310,9631,4355,5276,603,299,304,4280,2139,2141,4669,1878,2791,2624,979,1645,67,25,228,2,3,5,25,6,23,2
R01219,ñkäCìπ,ñ‰ï és,21215,9901,11314,20674,9803,10871,1971,992,979,11515,5782,5733,7697,3104,4593,4066,1474,2592,529,91,336,5,7,10,38,13,26,5
R01220,ñkäCìπ,émï és,17858,8416,9442,17756,8349,9407,1652,855,797,8803,4490,4313,7350,3044,4306,4118,1590,2528,76,71,264,1,12,9,20,9,30,3
R01221,ñkäCìπ,ñºäÒés,27282,13322,13960,27014,13167,13847,3018,1561,1457,15232,7893,7339,8747,3682,5065,4754,1846,2908,50,161,297,4,10,15,88,22,56,5
R01222,ñkäCìπ,éOä}és,8040,3631,4409,8025,3621,4404,655,315,340,3566,1845,1721,3819,1471,2348,2253,779,1474,15,38,194,2,4,3,9,3,13,2
R01223,ñkäCìπ,ç™é∫és,24636,11762,12874,24249,11666,12583,2396,1217,1179,13370,6832,6538,8648,3550,5098,4569,1694,2875,306,115,385,1,7,9,33,12,28,7
R01224,ñkäCìπ,êÁçŒés,97950,49790,48160,97223,49450,47773,13012,6681,6331,62066,32906,29160,22690,10088,12602,10977,4484,6493,704,708,915,5,56,46,128,60,134,18
R01225,ñkäCìπ,ëÍêÏés,39490,18832,20658,39013,18548,20465,3995,2104,1891,21161,10702,10459,13821,5682,8139,7223,2735,4488,109,214,579,4,24,26,85,35,97,5
R01226,ñkäCìπ,çªêÏés,16486,7607,8879,16450,7588,8862,1388,682,706,8138,3985,4153,6404,2640,3764,3548,1346,2202,29,76,295,1,7,8,106,15,65,3
R01227,ñkäCìπ,âÃéuì‡és,2989,1399,1590,2979,1393,1586,142,80,62,1252,659,593,1592,658,934,888,318,570,10,6,67,1,4,1,2,1,5,1
R01228,ñkäCìπ,ê[êÏés,20039,9362,10677,19927,9311,10616,1634,853,781,9802,4981,4821,8544,3482,5062,4873,1831,3042,110,84,348,3,14,13,61,18,41,8
R01229,ñkäCìπ,ïxó«ñÏés,21131,9947,11184,20825,9818,11007,2211,1126,1085,11512,5645,5867,7255,3073,4182,3933,1515,2418,224,125,278,2,11,13,46,18,51,1
R01230,ñkäCìπ,ìoï és,46391,22146,24245,46118,22023,24095,4775,2480,2295,24170,12215,11955,17287,7373,9914,9013,3563,5450,167,243,624,6,18,21,52,25,49,5
R01231,ñkäCìπ,åbíÎés,70331,34088,36243,69840,33832,36008,8701,4476,4225,41413,20687,20726,19673,8560,11113,9795,3882,5913,438,424,669,5,35,37,119,42,129,10
R01233,ñkäCìπ,à…íBés,32826,15176,17650,32644,15144,17500,3355,1714,1641,16832,8168,8664,12601,5268,7333,6740,2581,4159,180,162,507,2,25,19,68,21,70,8
R01234,ñkäCìπ,ñkçLìáés,58171,27763,30408,57695,27517,30178,6395,3267,3128,32140,15829,16311,19380,8514,10866,9376,3876,5500,369,253,621,5,36,32,58,43,88,12
R01235,ñkäCìπ,êŒéÎés,56869,27324,29545,56418,27146,29272,6821,3502,3319,30645,15273,15372,19402,8549,10853,8958,3614,5344,451,279,615,4,26,23,59,33,78,14
R01236,ñkäCìπ,ñkìlés,44302,20542,23760,44002,20505,23497,5444,2808,2636,25434,12184,13250,13332,5541,7791,6564,2395,4169,300,247,525,0,27,16,25,18,43,9
R01303,ñkäCìπ,ìñï í¨,15916,7703,8213,15739,7612,8127,1178,589,589,8983,4509,4474,5553,2482,3071,2834,1157,1677,119,47,203,0,13,6,23,117,62,2
R01304,ñkäCìπ,êVé¬í√ë∫,3044,1484,1560,3035,1477,1558,300,160,140,1591,852,739,1142,467,675,666,238,428,8,14,66,0,3,1,2,3,2,0
R01331,ñkäCìπ,èºëOí¨,6260,2805,3455,6218,2800,3418,377,187,190,2611,1272,1339,3266,1343,1923,1804,675,1129,42,21,132,1,3,4,8,3,10,2
R01332,ñkäCìπ,ïüìáí¨,3794,1755,2039,3758,1753,2005,228,103,125,1711,871,840,1851,778,1073,973,364,609,36,13,81,0,3,2,2,2,2,1
R01333,ñkäCìπ,ímì‡í¨,4167,2060,2107,4104,2052,2052,357,176,181,2160,1156,1004,1649,727,922,854,320,534,63,14,63,0,4,2,2,2,1,1
R01334,ñkäCìπ,ñÿå√ì‡í¨,3832,1750,2082,3807,1745,2062,232,113,119,1678,831,847,1908,793,1115,1069,408,661,24,9,82,1,3,1,7,1,5,2
R01337,ñkäCìπ,éµî—í¨,27686,12679,15007,27574,12661,14913,3215,1637,1578,14743,6996,7747,9719,4040,5679,4906,1806,3100,112,138,394,2,17,10,36,13,25,6
R01343,ñkäCìπ,é≠ïîí¨,3760,1779,1981,3646,1756,1890,342,176,166,1901,919,982,1517,684,833,725,310,415,114,14,53,0,2,1,2,1,3,0
R01345,ñkäCìπ,êXí¨,14338,6658,7680,14000,6590,7410,1364,682,682,7403,3659,3744,5532,2289,3243,2727,1013,1714,313,57,251,2,7,6,17,7,11,3
R01346,ñkäCìπ,î™â_í¨,15826,7894,7932,15526,7746,7780,1591,831,760,8504,4600,3904,5534,2311,3223,2758,1006,1752,225,85,207,2,5,7,25,9,28,5
R01347,ñkäCìπ,í∑ñúïîí¨,5109,2448,2661,4932,2394,2538,415,200,215,2507,1337,1170,2088,854,1234,1193,419,774,177,23,93,1,2,3,4,4,5,1
R01361,ñkäCìπ,ç]ç∑í¨,7428,3569,3859,7406,3555,3851,589,295,294,3950,2097,1853,2846,1145,1701,1589,572,1017,19,25,104,2,4,4,15,4,16,4
R01362,ñkäCìπ,è„Émçëí¨,4306,1965,2341,4255,1944,2311,388,197,191,2047,986,1061,1868,779,1089,992,360,632,50,16,96,0,3,2,2,3,0,2
R01363,ñkäCìπ,å˙ëÚïîí¨,3592,1717,1875,3562,1711,1851,339,181,158,1713,882,831,1540,654,886,832,310,522,30,16,66,1,1,1,4,1,3,1
R01364,ñkäCìπ,â≥ïîí¨,3403,1538,1865,3386,1537,1849,284,142,142,1567,746,821,1552,650,902,857,332,525,17,14,66,1,1,1,4,2,3,1
R01367,ñkäCìπ,âúêKí¨,2410,1280,1130,2402,1276,1126,163,86,77,1250,774,476,997,420,577,543,207,336,8,10,55,1,3,0,3,1,2,0
R01370,ñkäCìπ,ç°ã‡í¨,5072,2446,2626,5068,2444,2624,468,236,232,2515,1334,1181,2089,876,1213,1176,458,718,4,22,85,1,4,2,6,2,9,1
R01371,ñkäCìπ,ÇπÇΩÇ»í¨,7398,3466,3932,7368,3462,3906,587,298,289,3323,1706,1617,3482,1459,2023,1985,764,1221,30,19,137,2,5,4,9,5,10,3
R01391,ñkäCìπ,ìáñqë∫,1356,687,669,1354,686,668,112,58,54,680,396,284,564,233,331,326,116,210,2,9,23,0,1,0,1,1,0,1
R01392,ñkäCìπ,éıìsí¨,2838,1397,1441,2784,1394,1390,258,139,119,1411,749,662,1167,508,659,641,240,401,54,14,47,0,3,2,5,2,2,1
R01393,ñkäCìπ,çïèºì‡í¨,2791,1353,1438,2775,1348,1427,304,163,141,1385,758,627,1102,432,670,686,238,448,16,9,42,0,5,1,6,1,2,1
R01394,ñkäCìπ,óñâzí¨,4568,2197,2371,4530,2175,2355,453,229,224,2285,1180,1105,1828,786,1042,1003,383,620,38,31,95,1,4,2,3,2,4,1
R01395,ñkäCìπ,ÉjÉZÉRí¨,5074,2624,2450,4799,2445,2354,619,339,280,2797,1484,1313,1307,595,712,637,245,392,246,42,56,0,2,2,2,3,4,1
R01396,ñkäCìπ,ê^éÎë∫,2045,1035,1010,2008,1006,1002,242,131,111,1098,602,496,705,302,403,389,148,241,37,13,29,0,3,1,2,1,3,1
R01397,ñkäCìπ,óØéıìsë∫,1911,971,940,1798,923,875,234,115,119,1184,638,546,493,218,275,270,106,164,113,14,18,0,2,1,2,1,0,1
R01398,ñkäCìπ,äÏñŒï í¨,2156,1112,1044,2093,1093,1000,177,92,85,1044,560,484,805,366,439,467,199,268,63,11,40,0,2,2,2,2,1,1
R01399,ñkäCìπ,ãûã…í¨,2941,1420,1521,2887,1410,1477,297,158,139,1446,733,713,1114,483,631,639,251,388,53,20,54,0,2,2,3,3,2,1
R01400,ñkäCìπ,ã‰ímà¿í¨,15129,7787,7342,14257,7301,6956,1941,999,942,9096,4995,4101,3731,1611,2120,1838,710,1128,589,126,121,1,11,7,41,9,28,2
R01401,ñkäCìπ,ã§òaí¨,5772,3047,2725,5763,3044,2719,650,340,310,3273,1884,1389,1826,800,1026,984,387,597,9,43,84,0,4,3,2,5,1,1
R01402,ñkäCìπ,ä‚ì‡í¨,11648,5500,6148,11599,5477,6122,1106,574,532,6157,3149,3008,4364,1757,2607,2283,830,1453,47,57,216,1,10,7,17,7,27,3
R01403,ñkäCìπ,îëë∫,1569,784,785,1566,784,782,147,80,67,797,461,336,625,243,382,383,133,250,3,9,41,0,3,1,2,1,0,1
R01404,ñkäCìπ,ê_åbì‡ë∫,870,400,470,869,399,470,65,28,37,357,195,162,448,177,271,280,89,191,1,4,20,0,1,1,2,1,0,1
R01405,ñkäCìπ,êœíOí¨,1831,855,976,1827,851,976,148,81,67,823,427,396,859,346,513,476,185,291,4,4,39,0,2,1,1,2,2,1
R01406,ñkäCìπ,å√ïΩí¨,2745,1307,1438,2692,1301,1391,207,111,96,1297,659,638,1154,492,662,643,255,388,53,3,56,0,1,2,1,2,2,1
R01407,ñkäCìπ,êmñÿí¨,3180,1526,1654,3113,1504,1609,344,178,166,1554,803,751,1282,545,737,673,247,426,67,19,56,0,3,2,2,2,1,1
R01408,ñkäCìπ,ó]ésí¨,18000,8342,9658,17863,8301,9562,1667,839,828,9020,4528,4492,7260,2943,4317,3830,1374,2456,125,83,288,1,14,12,27,15,36,3
R01409,ñkäCìπ,ê‘à‰êÏë∫,1165,606,559,1105,573,532,131,66,65,673,384,289,361,156,205,185,71,114,60,7,16,0,1,0,1,0,0,0
R01423,ñkäCìπ,ìÏñyí¨,7319,3461,3858,7273,3458,3815,693,357,336,4057,1981,2076,2555,1117,1438,1314,515,799,46,36,90,1,2,5,6,7,4,1
R01424,ñkäCìπ,ìﬁà‰ç]í¨,5120,2405,2715,5091,2389,2702,439,233,206,2490,1268,1222,2189,902,1287,1236,451,785,28,21,85,1,3,3,8,3,5,1
R01425,ñkäCìπ,è„çªêÏí¨,2841,1292,1549,2824,1281,1543,182,96,86,1201,613,588,1458,583,875,861,291,570,17,11,69,0,3,1,2,1,2,1
R01427,ñkäCìπ,óRêmí¨,4822,2302,2520,4798,2292,2506,401,219,182,2324,1202,1122,2044,851,1193,1135,419,716,24,16,83,0,5,4,4,5,5,2
R01428,ñkäCìπ,í∑è¿í¨,10289,4919,5370,10239,4889,5350,1010,520,490,5280,2701,2579,3969,1678,2291,2219,849,1370,26,50,145,1,6,4,11,5,24,2
R01429,ñkäCìπ,åIéRí¨,11272,5176,6096,11233,5152,6081,1083,491,592,5528,2769,2759,4636,1894,2742,2598,951,1647,35,60,183,1,8,8,14,9,21,3
R01430,ñkäCìπ,åéå`í¨,3691,2185,1506,3678,2174,1504,214,113,101,2064,1439,625,1376,610,766,782,297,485,13,12,69,1,4,2,3,2,5,1
R01431,ñkäCìπ,âYâPí¨,1732,845,887,1724,843,881,173,83,90,781,417,364,777,344,433,431,172,259,8,7,30,0,3,1,1,0,1,1
R01432,ñkäCìπ,êVè\í√êÏí¨,6484,2976,3508,6465,2968,3497,719,355,364,3099,1535,1564,2666,1086,1580,1537,581,956,19,27,95,1,2,3,8,4,10,1
R01433,ñkäCìπ,ñÖîwãçí¨,2693,1290,1403,2650,1256,1394,217,111,106,1207,638,569,1269,541,728,704,281,423,43,7,56,0,1,2,2,4,0,1
R01434,ñkäCìπ,íÅïÉï í¨,2329,1072,1257,2326,1071,1255,229,104,125,1093,544,549,985,411,574,590,220,370,3,14,37,0,2,1,1,1,1,1
R01436,ñkäCìπ,âJó≥í¨,2389,1165,1224,2380,1164,1216,194,101,93,1186,634,552,1009,430,579,588,220,368,9,4,44,1,1,1,2,1,1,1
R01437,ñkäCìπ,ñkó≥í¨,1724,823,901,1718,820,898,162,77,85,787,403,384,775,343,432,485,207,278,6,11,40,0,2,1,1,2,0,1
R01438,ñkäCìπ,è¿ìcí¨,2909,1392,1517,2903,1387,1516,257,122,135,1412,735,677,1240,535,705,716,279,437,6,14,41,0,3,2,2,2,1,1
R01452,ñkäCìπ,ëÈê≤í¨,6567,3105,3462,6564,3102,3462,804,435,369,3491,1679,1812,2272,991,1281,1182,477,705,3,30,78,0,2,2,1,2,3,3
R01453,ñkäCìπ,ìåê_äyí¨,10127,4702,5425,10084,4682,5402,1545,795,750,5638,2664,2974,2929,1232,1697,1544,573,971,43,46,119,0,3,4,10,6,4,2
R01454,ñkäCìπ,ìññÉí¨,6319,2912,3407,6309,2906,3403,649,308,341,3011,1480,1531,2659,1124,1535,1532,578,954,10,30,97,0,4,2,3,3,6,1
R01455,ñkäCìπ,î‰ïzí¨,3520,1662,1858,3517,1662,1855,353,174,179,1706,871,835,1461,617,844,848,320,528,3,13,47,0,4,1,1,2,3,1
R01456,ñkäCìπ,à§ï í¨,2605,1215,1390,2565,1213,1352,221,125,96,1178,585,593,1206,505,701,703,274,429,40,7,48,0,2,1,1,1,1,1
R01457,ñkäCìπ,è„êÏí¨,3500,1708,1792,3452,1688,1764,263,133,130,1687,931,756,1550,644,906,880,342,538,48,17,43,0,3,3,3,3,6,1
R01458,ñkäCìπ,ìåêÏí¨,8314,3877,4437,8048,3771,4277,1085,547,538,4469,2162,2307,2759,1168,1591,1490,572,918,266,40,103,0,3,3,3,3,7,1
R01459,ñkäCìπ,î¸âlí¨,9668,4495,5173,9582,4459,5123,927,430,497,4992,2479,2513,3749,1586,2163,2133,832,1301,86,42,140,1,3,4,8,5,14,2
R01460,ñkäCìπ,è„ïxó«ñÏí¨,10348,5363,4985,10266,5330,4936,1195,642,553,5741,3210,2531,3314,1446,1868,1760,721,1039,60,64,111,1,4,6,5,7,15,4
R01461,ñkäCìπ,íÜïxó«ñÏí¨,4733,2260,2473,4699,2255,2444,594,295,299,2406,1199,1207,1731,764,967,962,387,575,34,24,81,1,1,2,2,2,3,1
R01462,ñkäCìπ,ìÏïxó«ñÏí¨,2376,1228,1148,2358,1218,1140,250,123,127,1355,772,583,766,328,438,438,161,277,18,10,46,0,6,1,2,1,4,2
R01463,ñkäCìπ,êËä•ë∫,1306,653,653,1161,572,589,100,46,54,847,432,415,305,142,163,142,58,84,145,9,10,0,2,3,1,1,0,0
R01464,ñkäCìπ,òaä¶í¨,3192,1497,1695,3170,1482,1688,308,170,138,1470,743,727,1414,584,830,853,324,529,22,13,51,1,4,2,3,3,4,1
R01465,ñkäCìπ,åïï£í¨,2926,1425,1501,2925,1425,1500,279,161,118,1451,749,702,1196,515,681,658,251,407,1,16,38,0,3,2,1,2,2,1
R01468,ñkäCìπ,â∫êÏí¨,3126,1491,1635,3100,1479,1621,316,160,156,1514,789,725,1257,523,734,713,275,438,26,17,60,1,1,1,0,1,3,1
R01469,ñkäCìπ,î¸ê[í¨,4145,2038,2107,4110,2021,2089,369,197,172,2075,1095,980,1699,744,955,974,395,579,35,15,64,1,4,1,3,3,1,1
R01470,ñkäCìπ,âπà–éqï{ë∫,706,365,341,705,364,341,44,22,22,432,238,194,208,97,111,115,49,66,1,7,8,0,1,0,1,0,1,0
R01471,ñkäCìπ,íÜêÏí¨,1528,805,723,1495,786,709,140,73,67,770,456,314,593,264,329,354,145,209,8,5,25,0,2,1,1,1,1,1
R01472,ñkäCìπ,ñyâ¡ì‡í¨,1370,681,689,1368,680,688,120,68,52,691,370,321,559,243,316,344,143,201,2,4,27,0,5,1,2,1,1,1
R01481,ñkäCìπ,ëùñ—í¨,3908,1776,2132,3828,1752,2076,323,172,151,1857,937,920,1728,667,1061,950,330,620,80,21,89,0,5,1,2,2,4,1
R01482,ñkäCìπ,è¨ïΩí¨,2994,1431,1563,2927,1411,1516,265,146,119,1527,790,737,1201,494,707,703,263,440,67,13,53,0,3,2,1,1,0,0
R01483,ñkäCìπ,ìœëOí¨,2936,1428,1508,2910,1418,1492,285,153,132,1463,769,694,1186,505,681,708,282,426,26,9,52,0,3,2,2,1,1,2
R01484,ñkäCìπ,âHñyí¨,6548,3163,3385,6526,3150,3376,619,337,282,3096,1680,1416,2832,1145,1687,1607,591,1016,22,26,91,2,4,3,13,3,12,1
R01485,ñkäCìπ,èâéRï ë∫,1080,518,562,1072,512,560,90,46,44,569,285,284,421,187,234,254,104,150,8,7,17,0,4,1,2,1,0,0
R01486,ñkäCìπ,âìï í¨,2520,1222,1298,2460,1201,1259,248,129,119,1238,658,580,1034,435,599,592,227,365,60,9,59,1,1,1,1,1,4,1
R01487,ñkäCìπ,ìVâñí¨,2950,1478,1472,2912,1459,1453,300,152,148,1545,848,697,1097,472,625,543,206,337,34,12,31,1,1,2,1,2,3,1
R01511,ñkäCìπ,âéï•ë∫,2611,1285,1326,2450,1250,1200,366,183,183,1622,832,790,615,264,351,290,107,183,161,20,33,1,3,1,2,1,0,2
R01512,ñkäCìπ,ïlì⁄ï í¨,3448,1675,1773,3367,1665,1702,312,151,161,1831,968,863,1293,544,749,667,257,410,75,15,47,1,2,2,2,0,5,1
R01513,ñkäCìπ,íÜì⁄ï í¨,1637,818,819,1633,816,817,160,80,80,822,459,363,655,279,376,379,156,223,4,11,31,1,3,1,2,1,2,1
R01514,ñkäCìπ,é}çKí¨,7565,3600,3965,7435,3588,3847,790,389,401,4078,2079,1999,2696,1132,1564,1387,535,852,130,44,127,1,4,4,4,4,7,2
R01516,ñkäCìπ,ñLïxí¨,3974,2098,1876,3932,2086,1846,388,218,170,2114,1172,942,1357,613,744,680,261,419,42,23,52,0,3,2,2,1,2,1
R01517,ñkäCìπ,óÁï∂í¨,2509,1284,1225,2481,1280,1201,259,133,126,1340,727,613,910,424,486,462,194,268,28,12,42,0,3,2,1,1,0,2
R01518,ñkäCìπ,óòêKí¨,2004,994,1010,2003,993,1010,185,94,91,1010,543,467,809,357,452,450,175,275,1,9,35,1,1,2,3,2,5,2
R01519,ñkäCìπ,óòêKïxémí¨,2458,1188,1270,2447,1187,1260,252,138,114,1265,657,608,941,393,548,553,209,344,11,14,53,0,3,2,2,2,3,2
R01520,ñkäCìπ,ñyâÑí¨,2371,1290,1081,2343,1275,1068,274,136,138,1416,849,567,681,305,376,306,111,195,28,18,35,0,4,1,0,1,1,1
R01543,ñkäCìπ,î¸ñyí¨,18697,9063,9634,18609,9051,9558,1928,990,938,10043,5189,4854,6713,2872,3841,3523,1377,2146,88,88,266,2,10,10,21,17,23,3
R01544,ñkäCìπ,í√ï í¨,4373,2096,2277,4363,2093,2270,365,179,186,1940,1056,884,1978,816,1162,1082,394,688,9,17,79,1,1,1,4,2,5,1
R01545,ñkäCìπ,éŒó¢í¨,11418,5672,5746,11231,5611,5620,1337,687,650,6221,3307,2914,3839,1659,2180,1940,764,1176,187,65,140,1,3,6,8,6,3,3
R01546,ñkäCìπ,ê¥ó¢í¨,3883,1882,2001,3879,1879,2000,453,247,206,1868,972,896,1484,628,856,865,327,538,2,24,66,0,2,2,2,2,3,2
R01547,ñkäCìπ,è¨ê¥êÖí¨,4623,2207,2416,4600,2206,2394,533,274,259,2312,1171,1141,1772,758,1014,980,379,601,23,25,90,1,1,1,5,1,7,1
R01549,ñkäCìπ,åPéqï{í¨,4677,2241,2436,4649,2228,2421,531,270,261,2314,1167,1147,1828,800,1028,989,390,599,28,25,77,0,2,2,1,3,2,1
R01550,ñkäCìπ,íuåÀí¨,2775,1281,1494,2770,1280,1490,270,127,143,1261,652,609,1244,502,742,743,278,465,5,16,58,1,1,1,2,1,3,1
R01552,ñkäCìπ,ç≤òCä‘í¨,4875,2296,2579,4653,2267,2386,492,259,233,2458,1212,1246,1924,824,1100,1055,428,627,222,25,82,0,2,2,2,2,3,1
R01555,ñkäCìπ,âìåyí¨,19241,9337,9904,19172,9320,9852,1961,1020,941,9521,4972,4549,7230,3041,4189,4019,1587,2432,69,93,286,2,14,10,48,11,41,8
R01559,ñkäCìπ,óNï í¨,8270,3947,4323,8125,3913,4212,781,391,390,4243,2186,2057,3246,1370,1876,1810,690,1120,145,45,158,1,3,3,2,5,5,4
R01560,ñkäCìπ,ëÍè„í¨,2421,1177,1244,2396,1165,1231,202,106,96,1135,607,528,1084,464,620,619,250,369,25,14,33,1,2,1,4,1,3,1
R01561,ñkäCìπ,ãªïîí¨,3628,1768,1860,3543,1740,1803,450,231,219,1969,1040,929,1209,497,712,624,236,388,85,28,38,1,0,2,2,2,3,2
R01562,ñkäCìπ,êºãªïîë∫,1053,520,533,1025,505,520,104,56,48,576,321,255,373,143,230,244,79,165,28,10,26,0,2,1,1,1,0,0
R01563,ñkäCìπ,óYïêí¨,4199,1999,2200,3971,1932,2039,432,221,211,2347,1191,1156,1420,587,833,753,288,465,228,23,67,1,2,1,3,2,5,1
R01564,ñkäCìπ,ëÂãÛí¨,6775,3287,3488,6762,3281,3481,798,396,402,3470,1790,1680,2507,1101,1406,1313,514,799,13,27,120,1,4,3,4,4,4,0
R01571,ñkäCìπ,ñLâYí¨,3821,1781,2040,3759,1749,2010,386,194,192,1916,960,956,1512,623,889,868,320,548,62,12,71,1,5,1,2,1,2,2
R01575,ñkäCìπ,ësïÀí¨,2743,1285,1458,2717,1276,1441,227,121,106,1227,619,608,1237,516,721,736,268,468,26,8,40,1,1,1,10,1,5,1
R01578,ñkäCìπ,îíòVí¨,16212,7706,8506,16014,7666,8348,1104,557,547,7639,3908,3731,7428,3212,4216,3901,1565,2336,189,43,271,1,6,8,10,10,5,4
R01581,ñkäCìπ,å˙ê^í¨,4432,2249,2183,4386,2209,2177,567,302,265,2236,1207,1029,1613,728,885,885,365,520,46,29,60,0,1,2,2,2,2,2
R01584,ñkäCìπ,ì¥ñÍåŒí¨,8442,3909,4533,8352,3870,4482,706,361,345,4031,1981,2050,3679,1548,2131,2105,798,1307,88,33,169,2,7,4,17,6,21,4
R01585,ñkäCìπ,à¿ïΩí¨,7340,3632,3708,7267,3603,3664,754,361,393,3873,2093,1780,2712,1177,1535,1473,589,884,73,30,125,1,4,4,3,4,6,2
R01586,ñkäCìπ,ÇﬁÇ©ÇÌí¨,7651,3779,3872,7509,3687,3822,707,352,355,3781,2035,1746,3122,1361,1761,1675,667,1008,142,35,110,1,3,4,6,5,6,2
R01601,ñkäCìπ,ì˙çÇí¨,11279,5712,5567,11019,5509,5510,1209,630,579,6008,3292,2716,4062,1790,2272,2145,875,1270,260,65,174,1,7,7,11,7,14,4
R01602,ñkäCìπ,ïΩéÊí¨,4776,2395,2381,4649,2318,2331,553,289,264,2537,1377,1160,1680,725,955,874,343,531,127,20,78,1,2,4,4,4,4,4
R01604,ñkäCìπ,êVä•í¨,5309,2603,2706,5163,2502,2661,656,316,340,2894,1538,1356,1747,741,1006,920,350,570,146,22,83,0,4,2,3,2,3,1
R01607,ñkäCìπ,âYâÕí¨,12074,5975,6099,11818,5758,6060,1242,654,588,6735,3629,3106,4097,1692,2405,2153,800,1353,256,73,133,1,8,7,24,8,23,7
R01608,ñkäCìπ,óléóí¨,4043,1923,2120,4017,1913,2104,363,185,178,1970,984,986,1710,754,956,873,338,535,26,17,73,0,3,2,1,2,3,1
R01609,ñkäCìπ,Ç¶ÇËÇ‡í¨,4374,2230,2144,4335,2206,2129,537,271,266,2398,1334,1064,1438,624,814,668,244,424,39,18,78,0,5,2,4,2,2,3
R01610,ñkäCìπ,êVÇ–ÇæÇ©í¨,21517,10473,11044,21385,10394,10991,2424,1222,1202,11396,5954,5442,7608,3238,4370,4047,1585,2462,103,125,284,3,13,10,31,14,50,9
R01631,ñkäCìπ,âπçXí¨,43576,20630,22946,43413,20532,22881,5656,2886,2770,24865,12170,12695,12907,5474,7433,6753,2646,4107,107,245,489,3,18,18,42,25,56,8
R01632,ñkäCìπ,émñyí¨,5848,2891,2957,5758,2836,2922,734,380,354,3168,1656,1512,1938,848,1090,980,370,610,90,33,91,1,2,3,3,3,4,2
R01633,ñkäCìπ,è„émñyí¨,4778,2343,2435,4642,2274,2368,550,282,268,2537,1348,1189,1690,713,977,997,378,619,136,31,70,0,3,2,3,2,5,1
R01634,ñkäCìπ,é≠í«í¨,5266,2572,2694,5191,2551,2640,714,353,361,2915,1497,1418,1629,718,911,885,353,532,75,27,53,1,3,1,4,1,2,1
R01635,ñkäCìπ,êVìæí¨,5817,2900,2917,5784,2888,2896,591,315,276,3027,1622,1405,2199,963,1236,1219,496,723,33,28,91,0,6,5,3,5,5,2
R01636,ñkäCìπ,ê¥êÖí¨,9094,4478,4616,8955,4424,4531,909,466,443,4529,2380,2149,3388,1471,1917,1875,744,1131,135,40,124,2,4,3,8,5,15,2
R01637,ñkäCìπ,âËé∫í¨,18048,8612,9436,17978,8577,9401,2462,1254,1208,10010,4905,5105,5535,2423,3112,2907,1155,1752,60,94,193,1,4,9,16,11,24,3
R01638,ñkäCìπ,íÜéDì‡ë∫,3884,1880,2004,3808,1866,1942,491,241,250,2275,1176,1099,1118,463,655,618,240,378,76,25,42,0,3,2,1,2,2,1
R01639,ñkäCìπ,çXï ë∫,3080,1519,1561,3072,1515,1557,405,221,184,1706,878,828,969,420,549,551,212,339,8,20,40,0,2,1,4,1,2,1
R01641,ñkäCìπ,ëÂé˜í¨,5420,2714,2706,5312,2666,2646,612,313,299,2825,1520,1305,1983,881,1102,1107,462,645,108,37,87,1,3,2,9,2,7,3
R01642,ñkäCìπ,çLîˆí¨,6387,3096,3291,6336,3087,3249,609,302,307,3247,1707,1540,2517,1075,1442,1352,529,823,51,37,103,1,4,3,5,3,9,2
R01643,ñkäCìπ,ñãï í¨,25766,12243,13523,25623,12195,13428,3168,1656,1512,13900,6763,7137,8658,3798,4860,4470,1845,2625,108,151,327,1,13,10,14,14,19,5
R01644,ñkäCìπ,írìcí¨,6294,2967,3327,6272,2961,3311,520,258,262,3029,1558,1471,2743,1149,1594,1536,604,932,22,24,126,1,6,4,10,4,7,1
R01645,ñkäCìπ,ñLç†í¨,3022,1478,1544,2972,1465,1507,294,147,147,1536,807,729,1192,524,668,685,285,400,50,16,42,0,4,1,1,1,2,1
R01646,ñkäCìπ,ñ{ï í¨,6618,3228,3390,6576,3199,3377,579,315,264,3281,1763,1518,2756,1149,1607,1501,578,923,42,31,127,1,3,4,8,5,5,1
R01647,ñkäCìπ,ë´äÒí¨,6563,3215,3348,6536,3206,3330,732,391,341,3199,1665,1534,2618,1146,1472,1455,592,863,26,29,102,1,3,2,5,2,10,1
R01648,ñkäCìπ,ó§ï í¨,2264,1138,1126,2223,1125,1098,224,113,111,1154,639,515,886,386,500,495,205,290,41,10,41,0,4,1,2,0,5,0
R01649,ñkäCìπ,âYñyí¨,4387,2138,2249,4353,2122,2231,425,220,205,2088,1118,970,1865,791,1074,986,379,607,34,28,65,0,4,2,2,2,4,1
R01661,ñkäCìπ,ã˙òHí¨,19105,9101,10004,18911,8968,9943,2153,1120,1033,11091,5421,5670,5704,2455,3249,2581,974,1607,72,139,188,0,9,9,9,10,23,5
R01662,ñkäCìπ,å˙ä›í¨,8892,4173,4719,8736,4143,4593,900,458,442,4809,2382,2427,3182,1332,1850,1698,646,1052,156,35,128,1,2,5,5,6,9,2
R01663,ñkäCìπ,ïlíÜí¨,5507,2726,2781,5423,2716,2707,633,327,306,3109,1595,1514,1759,799,960,837,335,502,84,40,84,0,2,2,1,2,2,2
R01664,ñkäCìπ,ïWíÉí¨,7230,3471,3759,7135,3454,3681,861,437,424,3894,1960,1934,2475,1074,1401,1290,507,783,95,43,91,1,1,3,3,3,4,5
R01665,ñkäCìπ,íÌéqã¸í¨,6955,3314,3641,6884,3291,3593,605,305,300,3405,1743,1662,2854,1227,1627,1537,610,927,48,30,135,2,5,3,10,4,7,2
R01667,ñkäCìπ,íﬂãèë∫,2558,1254,1304,2523,1247,1276,298,148,150,1339,702,637,910,397,513,480,191,289,35,15,30,1,1,1,7,1,1,1
R01668,ñkäCìπ,îíçfí¨,7289,3414,3875,7199,3405,3794,564,300,264,3660,1812,1848,3063,1300,1763,1575,605,970,90,22,107,0,5,4,4,4,5,3
R01691,ñkäCìπ,ï äCí¨,14380,7286,7094,13972,7109,6863,1849,955,894,7996,4210,3786,3992,1795,2197,1872,746,1126,395,105,154,1,6,4,10,4,9,3
R01692,ñkäCìπ,íÜïWí√í¨,23010,11339,11671,22883,11276,11607,3021,1543,1478,13749,7065,6684,6151,2662,3489,2934,1152,1782,107,163,208,2,7,10,26,11,28,2
R01693,ñkäCìπ,ïWí√í¨,5023,2465,2558,4946,2427,2519,637,312,325,2796,1459,1337,1571,678,893,782,309,473,77,33,55,1,1,1,4,2,5,2
R01694,ñkäCìπ,óÖâPí¨,4722,2346,2376,4680,2333,2347,516,251,265,2718,1460,1258,1484,631,853,749,280,469,42,21,66,0,2,1,1,1,2,0
R02201,ê¬êXåß,ê¬êXés,275192,128049,147143,271454,126081,145373,28040,14189,13851,150122,72936,77186,84787,34223,50564,42083,14881,27202,922,1480,3566,16,211,132,679,187,694,89
R02202,ê¬êXåß,çOëOés,168466,77251,91215,166298,76408,89890,17417,8953,8464,95115,45946,49169,53922,21384,32538,27960,9684,18276,641,1041,2435,12,163,93,842,146,474,65
R02203,ê¬êXåß,î™åÀés,223415,106818,116597,220832,105377,115455,25636,13155,12481,126567,63266,63301,69328,29160,40168,34454,12788,21666,1096,1378,2750,16,162,94,551,157,463,81
R02204,ê¬êXåß,çïêŒés,31946,14789,17157,31778,14737,17041,3214,1645,1569,17723,8693,9030,10943,4419,6524,5403,1854,3549,116,165,488,2,15,13,56,12,48,15
R02205,ê¬êXåß,å‹èäêÏå¥és,51415,23252,28163,51001,23043,27958,4852,2448,2404,27798,13231,14567,18363,7323,11040,9807,3405,6402,97,251,799,5,42,23,126,29,135,21
R02206,ê¬êXåß,è\òaìcés,60378,28685,31693,59560,28363,31197,6398,3297,3101,33001,16559,16442,20320,8514,11806,10052,3691,6361,310,327,865,3,41,20,121,28,117,26
R02207,ê¬êXåß,éOëÚés,39152,19602,19550,38211,19154,19057,4994,2573,2421,23094,12228,10866,10385,4326,6059,5252,1833,3419,659,323,404,3,19,16,60,25,53,18
R02208,ê¬êXåß,ÇﬁÇ¬és,54103,26104,27999,53212,25728,27484,5714,2952,2762,29283,15127,14156,18249,7589,10660,8939,3279,5660,153,284,821,3,35,18,95,22,89,15
R02209,ê¬êXåß,Ç¬Ç™ÇÈés,30934,14363,16571,30849,14332,16517,2903,1469,1434,16001,8097,7904,12002,4782,7220,6586,2246,4340,58,135,490,1,12,9,15,12,16,14
R02210,ê¬êXåß,ïΩêÏés,30567,14188,16379,30515,14177,16338,3282,1667,1615,16504,8166,8338,10777,4354,6423,5649,1967,3682,48,151,484,0,19,9,18,10,20,13
R02301,ê¬êXåß,ïΩì‡í¨,10126,4818,5308,10079,4811,5268,906,462,444,5050,2584,2466,4164,1768,2396,1981,691,1290,47,33,173,1,6,3,7,2,12,5
R02303,ê¬êXåß,ç°ï í¨,2334,1119,1215,2331,1117,1214,105,59,46,939,511,428,1290,549,741,721,264,457,3,7,64,0,3,1,2,2,3,1
R02304,ê¬êXåß,ñHìcë∫,2540,1211,1329,2538,1211,1327,247,144,103,1216,591,625,1077,476,601,559,214,345,2,3,51,0,2,0,1,0,0,1
R02307,ê¬êXåß,äOÉñïlí¨,5401,2527,2874,5365,2521,2844,285,162,123,2362,1255,1107,2750,1106,1644,1573,563,1010,36,7,121,1,7,1,8,1,9,1
R02321,ê¬êXåß,ÈÀÉñëÚí¨,9044,4145,4899,9022,4136,4886,701,360,341,4299,2151,2148,4034,1628,2406,2227,783,1444,14,25,208,1,5,3,10,4,11,5
R02323,ê¬êXåß,ê[âYí¨,7346,3397,3949,7324,3393,3931,481,244,237,3139,1599,1540,3726,1554,2172,2147,814,1333,22,20,175,0,5,2,3,3,4,8
R02343,ê¬êXåß,êºñ⁄âÆë∫,1265,589,676,1265,589,676,151,69,82,613,321,292,501,199,302,291,95,196,0,4,27,0,1,0,0,0,0,1
R02361,ê¬êXåß,ì°çËí¨,14573,6748,7825,14544,6743,7801,1679,849,830,8090,3959,4131,4797,1936,2861,2506,821,1685,27,98,213,1,8,7,19,7,19,6
R02362,ê¬êXåß,ëÂòkí¨,8665,3934,4731,8663,3933,4730,631,311,320,4262,2098,2164,3771,1525,2246,2007,691,1316,2,35,171,1,5,2,10,3,9,3
R02367,ê¬êXåß,ìcé…äŸë∫,7326,3425,3901,7312,3420,3892,836,411,425,3845,1961,1884,2639,1048,1591,1386,471,915,11,49,125,0,2,1,1,1,0,3
R02381,ê¬êXåß,î¬ñˆí¨,12700,5806,6894,12681,5796,6885,1205,618,587,6672,3251,3421,4822,1936,2886,2614,932,1682,19,59,228,1,5,6,8,7,8,6
R02384,ê¬êXåß,íﬂìcí¨,12074,5553,6521,12059,5550,6509,1263,637,626,6236,3083,3153,4575,1833,2742,2497,867,1630,15,48,189,0,6,3,9,3,10,6
R02387,ê¬êXåß,íÜîëí¨,9657,4432,5225,9593,4413,5180,756,381,375,4612,2259,2353,4289,1792,2497,2288,824,1464,64,33,230,0,8,3,4,4,2,4
R02401,ê¬êXåß,ñÏï”íní¨,12374,5776,6598,12223,5732,6491,1102,536,566,6556,3308,3248,4713,1931,2782,2417,871,1546,151,35,200,1,5,8,18,9,11,4
R02402,ê¬êXåß,éµåÀí¨,14556,6964,7592,14502,6937,7565,1406,708,698,7202,3745,3457,5943,2508,3435,3049,1109,1940,54,64,302,1,6,4,15,6,21,6
R02405,ê¬êXåß,òZåÀí¨,10447,5084,5363,10366,5045,5321,1394,703,691,5522,2830,2692,3531,1551,1980,1777,679,1098,81,66,140,0,5,3,4,5,6,4
R02406,ê¬êXåß,â°ïlí¨,4229,2071,2158,4153,2063,2090,359,188,171,2179,1182,997,1691,701,990,922,326,596,76,14,74,0,2,1,1,2,2,2
R02408,ê¬êXåß,ìåñkí¨,16428,7846,8582,16325,7813,8512,1721,870,851,8396,4339,4057,6300,2629,3671,3353,1183,2170,103,103,287,1,9,5,7,8,9,12
R02411,ê¬êXåß,òZÉñèäë∫,10367,5910,4457,10066,5721,4345,1065,549,516,6470,4041,2429,2618,1176,1442,1219,464,755,103,56,135,0,7,1,4,3,4,4
R02412,ê¬êXåß,Ç®Ç¢ÇÁÇπí¨,24273,11627,12646,23942,11505,12437,3308,1662,1646,13956,6901,7055,6671,2890,3781,3014,1110,1904,228,188,288,2,11,6,18,9,23,13
R02423,ê¬êXåß,ëÂä‘í¨,4718,2375,2343,4705,2373,2332,501,275,226,2496,1368,1128,1711,729,982,838,297,541,9,28,80,1,2,1,6,1,4,2
R02424,ê¬êXåß,ìåí ë∫,5955,3162,2793,5943,3156,2787,633,333,300,3205,1879,1326,2117,950,1167,1123,430,693,12,33,125,0,4,2,2,1,4,1
R02425,ê¬êXåß,ïóä‘âYë∫,1636,779,857,1633,779,854,125,60,65,751,387,364,757,329,428,385,154,231,3,6,48,0,1,0,1,0,0,1
R02426,ê¬êXåß,ç≤à‰ë∫,1788,883,905,1787,883,904,124,60,64,802,431,371,858,388,470,458,168,290,1,6,42,0,4,1,0,1,0,1
R02441,ê¬êXåß,éOåÀí¨,9082,4288,4794,9035,4277,4758,826,414,412,4412,2276,2136,3783,1561,2222,2045,737,1308,34,44,165,1,2,3,9,3,14,3
R02442,ê¬êXåß,å‹åÀí¨,16042,7676,8366,15970,7651,8319,1436,754,682,8139,4183,3956,6467,2739,3728,3375,1256,2119,72,73,285,1,8,7,13,10,21,5
R02443,ê¬êXåß,ìcéqí¨,4968,2376,2592,4955,2375,2580,417,219,198,2368,1221,1147,2182,936,1246,1192,456,736,13,22,91,0,3,2,4,3,3,2
R02445,ê¬êXåß,ìÏïîí¨,16809,7884,8925,16776,7879,8897,1558,771,787,8525,4312,4213,6725,2801,3924,3572,1274,2298,33,71,320,2,7,5,21,6,23,3
R02446,ê¬êXåß,äKè„í¨,13496,6827,6669,13278,6713,6565,1276,657,619,7697,4098,3599,4281,1917,2364,2002,738,1264,66,64,192,0,3,3,3,3,3,4
R02450,ê¬êXåß,êVãΩë∫,2197,1069,1128,2189,1068,1121,165,84,81,948,514,434,1084,471,613,615,223,392,8,8,54,0,1,0,2,0,1,1
R03201,ä‚éËåß,ê∑â™és,289731,136919,152812,282387,133025,149362,33602,16995,16607,167894,82155,85739,80035,33055,46980,41034,15090,25944,1321,1873,3135,22,262,196,843,445,879,74
R03202,ä‚éËåß,ã{å√és,50369,24381,25988,50044,24204,25840,5003,2547,2456,25994,13597,12397,19042,7996,11046,10378,3849,6529,125,265,861,2,32,20,90,29,91,16
R03203,ä‚éËåß,ëÂëDìnés,34728,16679,18049,34275,16547,17728,3379,1756,1623,17943,9178,8765,13055,5490,7565,7256,2680,4576,318,165,570,1,28,17,71,20,71,12
R03205,ä‚éËåß,â‘ä™és,93193,44423,48770,92424,44066,48358,10177,5180,4997,50113,25484,24629,32231,13358,18873,17531,6384,11147,373,492,1407,5,69,34,103,47,194,38
R03206,ä‚éËåß,ñkè„és,93045,46852,46193,91883,46335,45548,11420,5911,5509,54390,28867,25523,25238,10554,14684,12806,4660,8146,736,565,1061,2,63,38,183,55,181,20
R03207,ä‚éËåß,ãvéúés,33043,15883,17160,32588,15732,16856,3697,1951,1746,17697,8877,8820,11006,4637,6369,5805,2113,3692,324,195,492,2,21,12,68,18,50,20
R03208,ä‚éËåß,âìñÏés,25366,12222,13144,25201,12165,13036,2554,1300,1254,12497,6553,5944,10283,4345,5938,5824,2104,3720,155,126,500,1,16,10,26,13,35,14
R03209,ä‚éËåß,àÍä÷és,111932,54254,57678,110816,53882,56934,11563,5993,5570,58370,30001,28369,41306,17815,23491,22181,8184,13997,799,553,1780,9,85,47,214,66,210,34
R03210,ä‚éËåß,ó§ëOçÇìcés,18262,8831,9431,18072,8787,9285,1637,843,794,9223,4815,4408,7356,3137,4219,4183,1590,2593,173,95,347,2,8,7,21,9,28,8
R03211,ä‚éËåß,äòêŒés,32078,15369,16709,31720,15231,16489,2949,1475,1474,16134,8459,7675,12778,5278,7500,7182,2636,4546,219,130,603,4,17,15,48,23,73,9
R03213,ä‚éËåß,ìÒåÀés,25513,11993,13520,25261,11935,13326,2541,1285,1256,13330,6699,6631,9509,3931,5578,5153,1868,3285,192,124,402,1,18,14,58,19,68,6
R03214,ä‚éËåß,î™î¶ïΩés,24023,11509,12514,23916,11465,12451,2117,1078,1039,11926,6125,5801,9944,4284,5660,5332,1937,3395,95,86,418,2,13,9,23,14,41,10
R03215,ä‚éËåß,âúèBés,112937,54840,58097,111896,54341,57555,12501,6438,6063,59785,30892,28893,39997,17092,22905,21732,8119,13613,589,627,1728,8,89,49,207,79,214,34
R03216,ä‚éËåß,ëÍëÚés,55579,27146,28433,55116,26949,28167,7614,3828,3786,33476,16882,16594,14164,6261,7903,6281,2546,3735,233,405,485,2,23,19,35,26,53,16
R03301,ä‚éËåß,é¥êŒí¨,15731,7505,8226,15689,7482,8207,1584,792,792,8066,4087,3979,6078,2625,3453,3177,1183,1994,42,64,278,2,10,6,18,8,19,6
R03302,ä‚éËåß,äãä™í¨,5634,2731,2903,5611,2727,2884,418,220,198,2498,1338,1160,2716,1171,1545,1501,552,949,23,22,122,1,3,3,6,4,7,1
R03303,ä‚éËåß,ä‚éËí¨,12285,5970,6315,12120,5851,6269,1081,537,544,6296,3315,2981,4896,2109,2787,2671,966,1705,165,63,246,0,12,5,11,9,11,5
R03321,ä‚éËåß,éáîgí¨,32147,15390,16757,32039,15338,16701,3948,2046,1902,18073,9001,9072,10088,4317,5771,4991,1887,3104,86,181,403,0,18,12,26,16,36,6
R03322,ä‚éËåß,ñÓã–í¨,28056,13337,14719,27756,13198,14558,3469,1758,1711,16894,8196,8698,7370,3189,4181,3458,1277,2181,104,180,235,4,19,13,554,62,169,9
R03366,ä‚éËåß,êºòaâÍí¨,5134,2380,2754,5110,2374,2736,360,186,174,2155,1148,1007,2619,1046,1573,1608,535,1073,24,13,124,1,5,2,7,5,6,5
R03381,ä‚éËåß,ã‡ÉPçËí¨,15535,8030,7505,15342,7927,7415,1832,969,863,8824,4909,3915,4765,2079,2686,2554,964,1590,145,106,195,0,12,6,15,8,10,3
R03402,ä‚éËåß,ïΩêÚí¨,7252,3500,3752,7213,3470,3743,791,400,391,3602,1882,1720,2859,1218,1641,1507,556,951,39,30,122,0,3,2,2,2,7,2
R03441,ä‚éËåß,èZìcí¨,5045,2470,2575,4939,2428,2511,376,194,182,2382,1276,1106,2287,1000,1287,1368,524,844,106,19,101,0,2,2,4,4,3,2
R03461,ä‚éËåß,ëÂí∆í¨,11004,5234,5770,10928,5217,5711,1129,587,542,5641,2836,2805,4199,1795,2404,2204,802,1402,51,54,207,1,7,3,12,4,15,5
R03482,ä‚éËåß,éRìcí¨,14320,6898,7422,14251,6864,7387,1374,724,650,7192,3712,3480,5745,2453,3292,3045,1141,1904,62,74,234,1,3,3,6,3,17,8
R03483,ä‚éËåß,ä‚êÚí¨,8726,4327,4399,8665,4305,4360,738,381,357,4103,2232,1871,3863,1693,2170,2202,835,1367,61,34,199,1,7,4,7,6,4,3
R03484,ä‚éËåß,ìcñÏî®ë∫,3059,1527,1532,3030,1518,1512,317,160,157,1446,769,677,1296,598,698,684,278,406,29,11,70,0,3,2,1,2,1,1
R03485,ä‚éËåß,ïÅë„ë∫,2487,1244,1243,2466,1233,1233,219,121,98,1200,655,545,1067,467,600,588,226,362,21,11,50,0,2,1,1,1,1,1
R03501,ä‚éËåß,åyïƒí¨,8421,4090,4331,8332,4087,4245,765,400,365,4134,2166,1968,3521,1524,1997,1926,703,1223,89,30,147,1,5,3,9,3,10,3
R03503,ä‚éËåß,ñÏìcë∫,3936,1863,2073,3913,1852,2061,429,215,214,1989,1010,979,1513,633,880,846,305,541,22,19,60,0,3,1,1,2,2,3
R03506,ä‚éËåß,ã„åÀë∫,5378,2556,2822,5362,2554,2808,511,275,236,2489,1277,1212,2378,1004,1374,1292,455,837,16,11,87,0,3,1,1,1,3,3
R03507,ä‚éËåß,ómñÏí¨,15091,7101,7990,15040,7079,7961,1365,694,671,7448,3762,3686,6274,2641,3633,3341,1210,2131,51,51,290,1,6,5,7,5,4,8
R03524,ä‚éËåß,àÍåÀí¨,11494,5498,5996,11340,5442,5898,987,524,463,5612,2882,2730,4881,2084,2797,2636,939,1697,149,44,245,1,10,5,22,8,23,5
R04100,ã{èÈåß,êÂë‰és,1096704,531617,565087,1052030,508588,543442,128665,66123,62542,673081,334398,338683,257223,110803,146420,127450,50154,77296,11507,7843,9165,47,939,597,3949,1244,3434,221
R04202,ã{èÈåß,êŒä™és,140151,68338,71813,137686,67255,70431,14579,7467,7112,76979,39552,37427,46507,20023,26484,24509,9392,15117,1071,745,1971,6,95,63,312,79,287,41
R04203,ã{èÈåß,âñ‚}és,52203,24877,27326,51434,24602,26832,5407,2774,2633,28777,14265,14512,17682,7612,10070,9144,3607,5537,503,245,703,3,41,22,159,33,125,11
R04205,ã{èÈåß,ãCêÂè¿és,61147,29905,31242,60187,29508,30679,5427,2765,2662,31637,16398,15239,23437,10252,13185,12639,4948,7691,582,243,978,3,36,19,97,33,84,11
R04206,ã{èÈåß,îíêŒés,32758,15976,16782,32380,15831,16549,3303,1727,1576,17574,9021,8553,11648,5114,6534,5999,2325,3674,214,119,464,2,24,13,66,17,75,8
R04207,ã{èÈåß,ñºéÊés,78718,38567,40151,77588,37998,39590,11872,6036,5836,47869,23785,24084,17878,8106,9772,8538,3481,5057,359,596,667,1,52,31,159,47,157,16
R04208,ã{èÈåß,äpìcés,27976,13797,14179,27717,13678,14039,2910,1462,1448,14931,7794,7137,10015,4462,5553,5015,1967,3048,206,123,462,3,14,11,23,11,37,4
R04209,ã{èÈåß,ëΩâÍèÈés,62827,31359,31468,61287,30554,30733,8186,4230,3956,37896,19578,18318,15490,6813,8677,7509,3022,4487,364,471,504,1,38,23,61,34,116,17
R04211,ã{èÈåß,ä‚è¿és,44068,21684,22384,43553,21435,22118,5840,3027,2813,26065,13216,12849,11755,5152,6603,5548,2195,3353,375,322,443,2,32,18,98,27,107,11
R04212,ã{èÈåß,ìoïƒés,76037,37163,38874,75501,36980,38521,8332,4296,4036,40399,20990,19409,26956,11687,15269,13740,5019,8721,328,390,1160,4,49,29,93,43,105,21
R04213,ã{èÈåß,åIå¥és,64637,31134,33503,64116,30975,33141,6262,3248,3014,31948,16500,15448,26204,11274,14930,14013,5116,8897,486,267,1198,4,52,28,107,45,99,12
R04214,ã{èÈåß,ìåèºìáés,39098,19089,20009,38931,19023,19908,4820,2441,2379,22690,11504,11186,11587,5143,6444,5630,2246,3384,142,247,460,2,25,14,50,17,69,10
R04215,ã{èÈåß,ëÂçËés,127330,62429,64901,126036,61814,64222,15025,7591,7434,72656,37418,35238,38738,16817,21921,19211,7152,12059,726,737,1657,12,79,46,322,71,283,33
R04216,ã{èÈåß,ïxíJés,51651,25091,26560,51273,24925,26348,8491,4296,4195,31812,15546,16266,11144,5144,6000,4735,2053,2682,219,290,305,2,27,20,48,24,78,11
R04301,ã{èÈåß,ë†â§í¨,11418,5569,5849,11342,5524,5818,1169,590,579,5864,3012,2852,4367,1957,2410,2253,860,1393,67,61,187,1,7,3,6,5,12,2
R04302,ã{èÈåß,éµÉñèhí¨,1262,620,642,1235,609,626,90,48,42,589,326,263,583,246,337,370,137,233,27,3,43,0,3,0,1,0,2,1
R04321,ã{èÈåß,ëÂâÕå¥í¨,23571,11530,12041,23293,11368,11925,3029,1545,1484,13789,6928,6861,6520,2907,3613,3268,1348,1920,125,155,255,1,17,15,119,19,81,5
R04322,ã{èÈåß,ë∫ìcí¨,10666,5293,5373,10568,5253,5315,1080,538,542,5749,3025,2724,3784,1709,2075,1886,739,1147,54,39,158,0,8,4,8,4,9,1
R04323,ã{èÈåß,éƒìcí¨,38271,19342,18929,37726,19063,18663,4368,2229,2139,22274,11711,10563,11032,5029,6003,5042,2174,2868,140,214,420,1,22,14,36,22,47,4
R04324,ã{èÈåß,êÏçËí¨,8345,4100,4245,8205,4077,4128,731,394,337,4381,2223,2158,3210,1467,1743,1559,602,957,127,37,120,2,4,2,13,5,7,1
R04341,ã{èÈåß,ä€êXí¨,12262,6117,6145,12117,6038,6079,1061,555,506,5889,3150,2739,5293,2400,2893,2882,1134,1748,133,41,223,1,4,5,6,7,13,3
R04361,ã{èÈåß,òjóùí¨,33087,16212,16875,32779,16045,16734,3790,1903,1887,18734,9465,9269,10389,4724,5665,4888,2025,2863,155,183,364,0,23,10,23,15,26,7
R04362,ã{èÈåß,éRå≥í¨,12046,5978,6068,11977,5943,6034,1074,565,509,6013,3131,2882,4943,2272,2671,2536,1067,1469,58,51,184,1,6,3,20,3,20,1
R04401,ã{èÈåß,èºìáí¨,13323,6414,6909,13257,6384,6873,1221,652,569,6881,3509,3372,5215,2247,2968,2826,1090,1736,63,59,222,1,4,4,13,7,16,3
R04404,ã{èÈåß,éµÉñïlí¨,18132,9024,9108,18014,8962,9052,1948,1025,923,10511,5380,5131,5644,2603,3041,2655,1092,1563,98,77,220,0,6,4,3,7,6,3
R04406,ã{èÈåß,óòï{í¨,35182,17162,18020,34963,17061,17902,5045,2582,2463,21264,10504,10760,8649,3956,4693,3812,1527,2285,120,228,260,2,17,13,49,18,58,9
R04421,ã{èÈåß,ëÂòaí¨,28786,14979,13807,28062,14607,13455,4115,2105,2010,17601,9525,8076,6502,2977,3525,3215,1254,1961,374,236,258,1,15,11,34,13,56,5
R04422,ã{èÈåß,ëÂãΩí¨,7813,3814,3999,7731,3767,3964,863,466,397,3926,2005,1921,3017,1339,1678,1504,568,936,79,37,130,0,3,2,3,2,2,1
R04424,ã{èÈåß,ëÂçtë∫,5849,2938,2911,5790,2897,2893,871,469,402,3263,1705,1558,1709,758,951,830,321,509,58,41,97,0,4,1,2,4,3,2
R04444,ã{èÈåß,êFñÉí¨,6698,3246,3452,6660,3239,3421,783,395,388,3560,1828,1732,2343,1015,1328,1160,411,749,34,36,98,1,1,1,8,2,9,2
R04445,ã{èÈåß,â¡î¸í¨,21943,10767,11176,21767,10684,11083,2327,1175,1152,11468,6003,5465,8137,3582,4555,4145,1558,2587,162,90,369,0,15,8,14,8,21,5
R04501,ã{èÈåß,óOíJí¨,15388,7520,7868,15305,7484,7821,1471,737,734,8091,4225,3866,5796,2540,3256,2856,1067,1789,57,62,257,2,7,7,17,12,21,2
R04505,ã{èÈåß,î¸ó¢í¨,23994,11616,12378,23912,11585,12327,2628,1347,1281,12743,6542,6201,8547,3669,4878,4340,1639,2701,64,100,343,2,11,9,14,14,21,3
R04581,ã{èÈåß,èóêÏí¨,6430,3351,3079,6218,3300,2918,521,263,258,3554,2049,1505,2333,1017,1316,1306,501,805,212,33,94,0,2,1,5,1,5,2
R04606,ã{èÈåß,ìÏéOó§í¨,12225,5980,6245,12061,5959,6102,1124,573,551,6387,3299,3088,4707,2102,2605,2545,943,1602,164,59,193,1,4,1,12,3,11,3
R05201,èHìcåß,èHìcés,307672,145411,162261,302311,142356,159955,32809,16793,16016,172755,84882,87873,95949,40000,55949,48525,17949,30576,1187,1752,3818,15,277,160,1268,240,890,77
R05202,èHìcåß,î\ë„és,49968,22932,27036,49759,22893,26866,4231,2179,2052,24953,12534,12419,20765,8209,12556,11466,3894,7572,208,219,822,4,54,22,144,35,130,16
R05203,èHìcåß,â°éËés,85555,40326,45229,85023,40160,44863,8532,4360,4172,43422,21841,21581,33401,14002,19399,17883,6592,11291,373,397,1409,3,79,44,207,56,178,29
R05204,èHìcåß,ëÂäŸés,69237,32551,36686,68649,32328,36321,6479,3356,3123,35272,17892,17380,26998,11008,15990,14851,5239,9612,295,319,1204,4,46,27,138,39,161,17
R05206,èHìcåß,íjé≠és,25154,11860,13294,25082,11825,13257,1723,886,837,11474,5879,5595,11809,5009,6800,6282,2316,3966,44,68,554,1,25,11,32,16,32,7
R05207,èHìcåß,ìíëÚés,42091,20115,21976,41952,20083,21869,3613,1874,1739,21485,11039,10446,16926,7165,9761,9195,3464,5731,114,164,838,1,34,21,64,34,56,10
R05209,èHìcåß,é≠äpés,29088,13684,15404,28942,13626,15316,2877,1432,1445,14259,7424,6835,11843,4756,7087,6521,2178,4343,89,119,543,3,15,13,40,17,54,10
R05210,èHìcåß,óRóòñ{ëëés,74707,35842,38865,74032,35551,38481,7467,3834,3633,38918,20169,18749,27783,11553,16230,14516,5114,9402,256,364,1196,5,60,28,190,41,162,27
R05211,èHìcåß,äÉè„és,31720,14967,16753,31549,14874,16675,3272,1709,1563,17095,8496,8599,11218,4672,6546,5637,2053,3584,85,156,471,2,19,9,40,13,37,6
R05212,èHìcåß,ëÂêÂés,77657,36287,41370,77124,36099,41025,7611,3881,3730,39751,19961,19790,29871,12264,17607,16022,5613,10409,226,361,1379,5,70,35,165,51,168,23
R05213,èHìcåß,ñkèHìcés,30198,14157,16041,30022,14118,15904,2437,1235,1202,14260,7419,6841,13438,5459,7979,7547,2644,4903,142,88,568,1,29,10,42,15,51,11
R05214,èHìcåß,Ç…Ç©ÇŸés,23435,11218,12217,23347,11167,12180,2244,1113,1131,12041,6278,5763,9140,3818,5322,4803,1722,3081,83,85,369,1,17,6,22,8,29,9
R05215,èHìcåß,êÂñkés,24610,11408,13202,24483,11376,13107,2135,1054,1081,11845,5960,5885,10533,4343,6190,5646,2009,3637,89,91,496,2,20,12,35,17,45,8
R05303,èHìcåß,è¨ç‚í¨,4780,2232,2548,4747,2224,2523,354,184,170,2281,1188,1093,2145,860,1285,1227,408,819,33,16,116,0,3,2,1,2,4,1
R05327,èHìcåß,è„è¨à¢êmë∫,2063,986,1077,2042,983,1059,117,60,57,839,458,381,1107,468,639,677,249,428,21,4,55,0,3,0,2,1,1,1
R05346,èHìcåß,ì°ó¢í¨,2896,1380,1516,2870,1377,1493,200,103,97,1283,674,609,1413,603,810,780,289,491,26,3,78,0,2,1,0,0,0,1
R05348,èHìcåß,éOéÌí¨,15254,7034,8220,15208,7024,8184,1167,565,602,7151,3636,3515,6935,2832,4103,3815,1302,2513,46,50,320,1,12,4,11,4,8,5
R05349,èHìcåß,î™ïÙí¨,6577,3071,3506,6529,3069,3460,442,221,221,3098,1604,1494,3036,1245,1791,1659,569,1090,48,22,131,0,6,2,1,2,5,1
R05361,èHìcåß,å‹èÈñ⁄í¨,8538,3985,4553,8520,3984,4536,596,296,300,3896,1992,1904,4038,1691,2347,2261,814,1447,18,30,179,0,8,2,6,4,12,1
R05363,èHìcåß,î™òYäÉí¨,5583,2534,3049,5557,2525,3032,423,205,218,2678,1329,1349,2477,998,1479,1331,447,884,26,24,100,1,3,1,11,2,15,1
R05366,èHìcåß,à‰êÏí¨,4566,2130,2436,4537,2116,2421,332,176,156,2231,1131,1100,1977,810,1167,1066,367,699,6,9,66,0,2,4,1,2,1,1
R05368,èHìcåß,ëÂäÉë∫,3011,1500,1511,2992,1490,1502,350,201,149,1686,875,811,954,411,543,558,244,314,19,16,34,0,2,1,1,1,1,1
R05434,èHìcåß,î¸ãΩí¨,18613,8701,9912,18561,8695,9866,1770,911,859,9474,4751,4723,7367,3037,4330,3973,1388,2585,49,69,314,0,10,5,8,8,8,3
R05463,èHìcåß,âHå„í¨,13825,6637,7188,13717,6623,7094,1286,679,607,7085,3599,3486,5437,2350,3087,2824,1025,1799,102,63,270,1,6,5,14,10,17,5
R05464,èHìcåß,ìåê¨ê£ë∫,2704,1491,1213,2637,1432,1205,206,120,86,1455,911,544,1008,425,583,545,186,359,66,10,49,0,3,1,1,1,1,1
R06201,éRå`åß,éRå`és,247590,119001,128589,244115,117270,126845,29120,14928,14192,140796,69625,71171,72341,31371,40970,38305,15038,23267,1156,1667,2899,13,248,141,1221,205,746,61
R06202,éRå`åß,ïƒëÚés,81252,40258,40994,80502,39940,40562,8881,4525,4356,46225,24293,21932,25259,10739,14520,13516,4965,8551,737,439,1069,5,64,36,166,51,171,19
R06203,éRå`åß,íﬂâ™és,122347,58626,63721,120978,58003,62975,13441,6816,6625,65098,33248,31850,43003,18075,24928,23042,8315,14727,635,681,1775,5,106,50,221,73,216,44
R06204,éRå`åß,éìcés,100273,47838,52435,99235,47475,51760,10305,5227,5078,53031,26996,26035,36091,15193,20898,18951,6902,12049,503,526,1535,3,99,45,266,71,215,33
R06205,éRå`åß,êVèØés,34432,16446,17986,33900,16291,17609,3863,1956,1907,18944,9547,9397,11370,4786,6584,5978,2231,3747,361,193,512,2,30,19,84,25,80,7
R06206,éRå`åß,ä¶âÕç]és,40189,19529,20660,39697,19368,20329,5040,2627,2413,22051,11139,10912,12859,5640,7219,6819,2632,4187,345,268,551,1,37,20,53,24,58,11
R06207,éRå`åß,è„éRés,29110,13909,15201,28782,13771,15011,2712,1371,1341,14828,7467,7361,11386,4970,6416,6009,2306,3703,147,130,460,2,24,12,55,20,72,6
R06208,éRå`åß,ë∫éRés,22516,10937,11579,22331,10906,11425,2193,1148,1045,11389,5785,5604,8903,3981,4922,4868,1888,2980,180,102,397,0,21,8,19,12,34,10
R06209,éRå`åß,í∑à‰és,26543,12953,13590,26167,12794,13373,2897,1493,1404,13989,7210,6779,9449,4096,5353,5166,1989,3177,340,153,442,2,22,11,29,16,42,6
R06210,éRå`åß,ìVì∂és,62140,30222,31918,61600,29948,31652,8060,4197,3863,35110,17581,17529,18761,8309,10452,9614,3823,5791,531,467,732,3,51,29,81,35,102,18
R06211,éRå`åß,ìåç™és,47682,23525,24157,47307,23408,23899,6548,3348,3200,27344,14086,13258,13441,5850,7591,7212,2764,4448,322,414,554,2,35,19,56,26,104,13
R06212,éRå`åß,îˆâ‘ëÚés,14971,7320,7651,14890,7312,7578,1459,769,690,7278,3777,3501,6232,2773,3459,3350,1268,2082,80,53,299,1,12,3,12,3,11,7
R06213,éRå`åß,ìÏózés,30420,14652,15768,30131,14540,15591,3516,1797,1719,16493,8346,8147,10339,4453,5886,5443,2047,3396,269,197,454,1,30,14,40,18,43,7
R06301,éRå`åß,éRï”í¨,13725,6603,7122,13678,6590,7088,1626,848,778,7372,3660,3712,4715,2091,2624,2439,982,1457,47,55,201,0,10,6,13,7,13,2
R06302,éRå`åß,íÜéRí¨,10746,5251,5495,10689,5227,5462,1132,583,549,5779,2967,2812,3835,1701,2134,1957,782,1175,57,57,169,0,5,2,4,4,0,1
R06321,éRå`åß,âÕñkí¨,17641,8528,9113,17454,8456,8998,1908,993,915,9078,4582,4496,6639,2943,3696,3525,1366,2159,181,84,275,1,21,10,43,10,39,2
R06322,éRå`åß,êºêÏí¨,4956,2387,2569,4914,2382,2532,425,216,209,2265,1142,1123,2262,1026,1236,1268,513,755,42,18,120,1,4,3,4,2,6,1
R06323,éRå`åß,í©ì˙í¨,6366,3150,3216,6314,3139,3175,561,296,265,2976,1561,1415,2828,1292,1536,1594,637,957,52,20,117,1,6,2,5,2,8,1
R06324,éRå`åß,ëÂç]í¨,7646,3797,3849,7559,3744,3815,761,422,339,3850,1999,1851,3035,1376,1659,1619,615,1004,87,23,153,0,3,3,3,5,0,2
R06341,éRå`åß,ëÂêŒìcí¨,6577,3213,3364,6499,3208,3291,603,311,292,3342,1715,1627,2632,1187,1445,1353,521,832,78,19,124,0,6,4,3,5,7,3
R06361,éRå`åß,ã‡éRí¨,5071,2466,2605,5014,2464,2550,547,278,269,2646,1358,1288,1878,830,1048,970,356,614,57,24,97,0,3,2,2,2,3,1
R06362,éRå`åß,ç≈è„í¨,8080,3913,4167,7998,3909,4089,838,424,414,3982,2042,1940,3260,1447,1813,1680,627,1053,82,35,160,1,3,2,5,3,8,2
R06363,éRå`åß,èMå`í¨,5007,2420,2587,4974,2420,2554,483,260,223,2421,1253,1168,2103,907,1196,1128,396,732,33,31,112,0,3,1,2,1,2,1
R06364,éRå`åß,ê^é∫êÏí¨,7203,3408,3795,7168,3390,3778,689,345,344,3508,1782,1726,3006,1281,1725,1621,592,1029,35,27,161,1,5,2,7,2,8,3
R06365,éRå`åß,ëÂë†ë∫,3028,1498,1530,3012,1497,1515,335,171,164,1505,795,710,1188,532,656,647,245,402,16,11,61,0,3,0,2,1,3,2
R06366,éRå`åß,ç¯êÏë∫,3902,1887,2015,3876,1885,1991,380,200,180,1942,999,943,1580,688,892,813,299,514,26,18,88,0,2,1,2,1,0,2
R06367,éRå`åß,åÀëÚë∫,4199,1987,2212,4139,1978,2161,367,175,192,2128,1084,1044,1704,728,976,899,302,597,60,14,91,0,3,0,1,0,1,1
R06381,éRå`åß,çÇî©í¨,22463,10950,11513,22264,10863,11401,2709,1407,1302,12134,6172,5962,7597,3355,4242,3908,1497,2411,196,118,312,1,13,9,20,15,22,6
R06382,éRå`åß,êÏêºí¨,14558,7101,7457,14477,7082,7395,1497,723,774,7370,3897,3473,5682,2475,3207,2991,1069,1922,68,65,224,2,7,4,130,10,46,3
R06401,éRå`åß,è¨çëí¨,7107,3573,3534,7047,3533,3514,688,338,350,3527,1956,1571,2882,1273,1609,1625,636,989,56,22,123,1,2,1,5,2,9,3
R06402,éRå`åß,îíëÈí¨,12890,6357,6533,12769,6314,6455,1382,745,637,6515,3334,3181,4990,2276,2714,2588,1032,1556,121,52,240,1,8,3,9,3,11,4
R06403,éRå`åß,î—ñLí¨,6613,3214,3399,6563,3199,3364,755,401,354,3300,1703,1597,2555,1108,1447,1362,486,876,48,37,149,0,4,0,1,0,4,2
R06426,éRå`åß,éOêÏí¨,7601,3694,3907,7566,3680,3886,994,539,455,3929,2032,1897,2664,1115,1549,1437,491,946,30,56,123,1,3,3,10,3,24,2
R06428,éRå`åß,èØì‡í¨,20151,9636,10515,20041,9599,10442,2161,1103,1058,10362,5305,5057,7578,3199,4379,4057,1484,2573,106,86,328,1,10,6,25,12,14,3
R06461,éRå`åß,óVç≤í¨,13032,6189,6843,12967,6157,6810,1210,611,599,6312,3254,3058,5507,2322,3185,2882,1022,1860,65,55,241,1,7,5,9,9,7,4
R07201,ïüìáåß,ïüìáés,282693,138190,144503,275185,134285,140900,31136,15969,15167,160024,81311,78713,84304,36593,47711,43183,16798,26385,1772,1803,3302,15,250,138,1216,199,749,55
R07202,ïüìáåß,âÔí√é·èºés,117376,56063,61313,114836,54958,59878,13716,7018,6698,65104,32693,32411,36307,15185,21122,18859,6777,12082,738,797,1537,6,90,55,384,89,316,29
R07203,ïüìáåß,åSéRés,327692,161830,165862,320053,157931,162122,39177,20023,19154,193417,98760,94657,86479,37650,48829,41984,16219,25765,2561,2301,3499,19,231,171,879,431,849,54
R07204,ïüìáåß,Ç¢ÇÌÇ´és,332931,163525,169406,324313,159711,164602,37979,19513,18466,184720,95531,89189,102319,44397,57922,51554,19646,31908,2439,1935,4208,20,248,160,473,228,805,69
R07205,ïüìáåß,îíâÕés,59491,29681,29810,58275,29096,29179,6995,3555,3440,34109,17880,16229,17546,7741,9805,8658,3365,5293,574,352,644,2,48,36,146,50,127,11
R07207,ïüìáåß,ê{âÍêÏés,74992,36781,38211,73901,36225,37676,9537,4845,4692,43226,22033,21193,21188,9340,11848,9995,3865,6130,375,507,860,5,51,36,130,49,130,19
R07208,ïüìáåß,äÏëΩï˚és,44760,21438,23322,44542,21372,23170,4905,2506,2399,23375,11939,11436,16479,6992,9487,9063,3216,5847,216,241,804,5,23,20,56,31,54,20
R07209,ïüìáåß,ëäînés,34865,17536,17329,34349,17265,17084,4215,2167,2048,19325,10274,9051,10792,4716,6076,5321,2009,3312,178,223,456,2,23,18,59,27,60,4
R07210,ïüìáåß,ìÒñ{èºés,53557,26305,27252,53129,26137,26992,5760,2939,2821,29073,14917,14156,18406,8244,10162,9191,3509,5682,344,320,693,3,37,20,72,23,75,15
R07211,ïüìáåß,ìcë∫és,35169,17320,17849,34719,17136,17583,3626,1809,1817,18763,9789,8974,12609,5613,6996,6926,2592,4334,311,174,562,1,22,14,25,18,34,6
R07212,ïüìáåß,ìÏëäînés,59005,31015,27990,57406,29911,27495,5099,2577,2522,30626,16953,13673,20796,9335,11461,10392,4046,6346,403,312,911,4,40,24,95,37,101,10
R07213,ïüìáåß,à…íBés,58240,28313,29927,57779,28144,29635,5961,2958,3003,31100,15927,15173,21008,9304,11704,11036,4361,6675,401,277,928,2,43,22,83,27,98,11
R07214,ïüìáåß,ñ{ã{és,30236,15018,15218,30050,14942,15108,3881,2032,1849,17765,9196,8569,8579,3784,4795,4284,1640,2644,186,190,369,1,14,13,24,16,50,8
R07301,ïüìáåß,åKê‹í¨,11459,5491,5968,11413,5475,5938,1200,605,595,5895,2979,2916,4347,1897,2450,2353,932,1421,35,49,213,0,7,7,4,10,11,1
R07303,ïüìáåß,çëå©í¨,8639,4114,4525,8580,4105,4475,727,366,361,4268,2129,2139,3642,1618,2024,1889,742,1147,59,28,134,1,3,3,47,4,34,1
R07308,ïüìáåß,êÏñìí¨,12170,5986,6184,11984,5914,6070,940,458,482,6005,3174,2831,5096,2286,2810,2688,1035,1653,105,40,252,1,11,5,14,5,19,1
R07322,ïüìáåß,ëÂã ë∫,8900,4427,4473,8843,4396,4447,1322,655,667,5095,2627,2468,2455,1130,1325,1123,422,701,47,77,101,0,1,1,0,1,0,1
R07342,ïüìáåß,ãæêŒí¨,12318,6030,6288,12268,6012,6256,1684,882,802,7187,3686,3501,3441,1462,1979,1661,608,1053,50,77,132,0,10,3,9,5,18,3
R07344,ïüìáåß,ìVâhë∫,5194,2567,2627,5138,2533,2605,530,280,250,2748,1431,1317,1916,856,1060,919,322,597,56,25,84,0,4,2,3,2,3,1
R07362,ïüìáåß,â∫ãΩí¨,5264,2602,2662,5248,2600,2648,476,244,232,2428,1285,1143,2360,1073,1287,1388,541,847,15,17,116,0,4,1,5,4,2,2
R07364,ïüìáåß,ûwé}äÚë∫,504,259,245,504,259,245,58,32,26,252,136,116,194,91,103,123,53,70,0,1,6,0,1,0,1,0,0,0
R07367,ïüìáåß,ë¸å©í¨,4044,1976,2068,4014,1962,2052,353,191,162,1783,967,816,1907,817,1090,1184,462,722,30,26,75,0,2,1,2,2,1,3
R07368,ïüìáåß,ìÏâÔí√í¨,14451,7116,7335,14370,7086,7284,1331,661,670,7030,3775,3255,6048,2647,3401,3517,1361,2156,68,55,277,1,14,8,16,10,16,5
R07402,ïüìáåß,ñkâñå¥ë∫,2556,1290,1266,2521,1277,1244,258,136,122,1349,725,624,948,428,520,441,155,286,35,11,39,0,2,0,1,0,1,1
R07405,ïüìáåß,êºâÔí√í¨,5770,2789,2981,5732,2782,2950,468,224,244,2582,1373,1209,2718,1190,1528,1604,585,1019,38,20,132,0,4,2,4,2,2,1
R07407,ïüìáåß,î÷íÚí¨,3322,1604,1718,3313,1599,1714,421,205,216,1655,872,783,1246,527,719,672,234,438,9,28,37,0,1,0,2,1,5,1
R07408,ïüìáåß,íñïcë„í¨,13552,6533,7019,13482,6506,6976,1422,738,684,6723,3473,3250,5360,2294,3066,2907,1034,1873,64,52,243,1,9,6,12,9,17,3
R07421,ïüìáåß,âÔí√ç‚â∫í¨,15068,7245,7823,14933,7188,7745,1611,821,790,7909,4032,3877,5522,2374,3148,2890,1018,1872,127,73,256,1,9,8,22,12,10,1
R07422,ïüìáåß,ìíêÏë∫,3081,1485,1596,3073,1485,1588,421,238,183,1594,789,805,1066,458,608,548,199,349,8,17,37,0,1,0,0,0,0,1
R07423,ïüìáåß,ñˆí√í¨,3081,1501,1580,3074,1500,1574,310,165,145,1374,740,634,1397,596,801,805,294,511,7,13,66,0,3,1,1,1,0,2
R07444,ïüìáåß,éOìáí¨,1452,714,738,1444,711,733,96,52,44,573,318,255,783,344,439,449,170,279,8,3,44,1,1,0,2,0,3,1
R07445,ïüìáåß,ã‡éRí¨,1862,908,954,1851,904,947,89,56,33,638,347,291,1134,505,629,736,287,449,11,4,78,0,4,0,1,1,2,2
R07446,ïüìáåß,è∫òaë∫,1246,623,623,1242,623,619,66,34,32,487,283,204,693,306,387,452,176,276,4,6,26,0,2,0,1,1,2,1
R07447,ïüìáåß,âÔí√î¸ó¢í¨,19014,9108,9906,18907,9074,9833,1904,969,935,9438,4835,4603,7528,3225,4303,4018,1448,2570,38,76,338,1,7,5,8,10,15,4
R07461,ïüìáåß,êºãΩë∫,20808,10636,10172,20387,10429,9958,2805,1449,1356,12432,6569,5863,5185,2373,2812,2289,901,1388,243,137,229,1,8,5,17,7,16,4
R07464,ïüìáåß,êÚçËë∫,6213,3061,3152,6095,3020,3075,776,385,391,3451,1773,1678,1986,903,1083,969,383,586,118,28,97,0,3,3,3,3,5,1
R07465,ïüìáåß,íÜìáë∫,4885,2398,2487,4850,2368,2482,632,305,327,2774,1447,1327,1479,646,833,744,261,483,35,24,59,0,3,3,1,4,2,1
R07466,ïüìáåß,ñÓêÅí¨,17287,8649,8638,17124,8559,8565,2132,1087,1045,9723,5162,4561,5429,2400,3029,2662,1031,1631,163,110,242,1,8,10,29,14,30,3
R07481,ïüìáåß,íIëqí¨,13343,6581,6762,13236,6538,6698,1630,823,807,7372,3849,3523,4258,1864,2394,2201,821,1380,71,70,181,0,9,5,10,8,11,1
R07482,ïüìáåß,ñÓç’í¨,5392,2620,2772,5369,2613,2756,600,292,308,2666,1395,1271,2126,933,1193,1163,431,732,23,25,94,0,4,2,2,3,1,1
R07483,ïüìáåß,î∑í¨,8302,4079,4223,8191,4041,4150,865,444,421,4214,2188,2026,3196,1429,1767,1749,673,1076,87,47,142,2,4,4,18,6,16,1
R07484,ïüìáåß,éLêÏë∫,3049,1531,1518,3031,1531,1500,316,157,159,1512,802,710,1221,572,649,650,268,382,18,15,53,0,2,1,1,1,0,1
R07501,ïüìáåß,êŒêÏí¨,14644,7334,7310,14493,7272,7221,1424,754,670,7719,4095,3624,5430,2434,2996,2784,1058,1726,108,63,201,0,10,9,13,15,19,4
R07502,ïüìáåß,ã êÏë∫,6392,3202,3190,6319,3155,3164,795,407,388,3565,1877,1688,2024,912,1112,946,368,578,71,38,74,0,4,1,2,2,9,1
R07503,ïüìáåß,ïΩìcë∫,5826,2883,2943,5706,2817,2889,584,299,285,3179,1699,1480,2057,879,1178,1064,358,706,120,16,87,1,2,3,4,5,6,2
R07504,ïüìáåß,êÛêÏí¨,6036,3031,3005,5990,3018,2972,682,353,329,3272,1733,1539,2055,932,1123,1081,426,655,23,31,100,0,2,2,1,4,4,1
R07505,ïüìáåß,å√ìaí¨,4825,2364,2461,4767,2356,2411,499,243,256,2433,1279,1154,1893,842,1051,1014,384,630,58,17,79,0,2,2,1,4,3,1
R07521,ïüìáåß,éOètí¨,17018,8448,8570,16923,8412,8511,1842,959,883,9177,4735,4442,5882,2678,3204,2901,1154,1747,58,87,226,1,12,6,16,7,25,3
R07522,ïüìáåß,è¨ñÏí¨,9471,4677,4794,9318,4586,4732,969,495,474,5074,2666,2408,3384,1491,1893,1800,683,1117,142,39,157,1,9,3,15,3,9,3
R07541,ïüìáåß,çLñÏí¨,5412,3311,2101,5330,3253,2077,384,198,186,2958,1889,1069,1558,729,829,687,267,420,75,17,66,1,4,1,4,0,9,1
R07542,ïüìáåß,ìËótí¨,3710,2147,1563,3683,2128,1555,259,132,127,1996,1276,720,1388,672,716,721,296,425,22,37,89,0,5,1,2,4,3,1
R07543,ïüìáåß,ïxâ™í¨,2128,1542,586,2040,1491,549,60,21,39,1382,1092,290,482,258,224,233,96,137,10,55,155,1,2,2,5,2,4,1
R07544,ïüìáåß,êÏì‡ë∫,2044,1035,1009,1947,1003,944,116,60,56,883,499,384,974,441,533,542,215,327,32,12,70,0,2,0,1,1,0,1
R07545,ïüìáåß,ëÂåFí¨,847,754,93,846,753,93,1,1,0,754,697,57,87,51,36,34,18,16,1,56,116,0,1,0,1,0,0,0
R07546,ïüìáåß,ëoótí¨,0,0,0,0,0,0,0,0,0,0,0,0,0,0,0,0,0,0,0,27,90,0,0,0,1,1,0,0
R07547,ïüìáåß,òQç]í¨,1923,1350,573,1772,1248,524,52,26,26,1056,806,250,568,321,247,242,119,123,5,63,227,0,1,1,3,2,3,1
R07548,ïüìáåß,äãîˆë∫,420,241,179,416,238,178,24,10,14,198,121,77,198,110,88,96,47,49,4,8,26,0,1,1,0,1,0,0
R07561,ïüìáåß,êVíní¨,7905,3945,3960,7847,3905,3942,997,528,469,4286,2229,2057,2597,1170,1427,1292,526,766,50,46,119,1,5,1,11,3,8,3
R07564,ïüìáåß,î—ä⁄ë∫,1318,662,656,1299,661,638,34,17,17,525,287,238,755,356,399,378,139,239,19,17,77,0,2,0,0,0,0,1
R08201,àÔèÈåß,êÖåÀés,270685,132537,138148,262174,128140,134034,33685,17307,16378,158472,79988,78484,70922,30822,40100,36916,14684,22232,2818,1969,2961,24,243,162,771,235,761,61
R08202,àÔèÈåß,ì˙óßés,174508,87126,87382,170416,85349,85067,17585,9002,8583,97706,51643,46063,56525,25302,31223,30984,13256,17728,1493,904,2171,12,107,74,349,107,370,30
R08203,àÔèÈåß,ìyâYés,142074,70935,71139,135299,67408,67891,15510,8049,7461,82307,42866,39441,40903,18096,22807,20802,8524,12278,3650,792,1650,6,106,84,444,125,394,26
R08204,àÔèÈåß,å√âÕés,139344,69735,69609,135242,67635,67607,16213,8201,8012,82127,42883,39244,39691,18018,21673,18734,7828,10906,3020,857,1527,8,78,65,204,111,287,31
R08205,àÔèÈåß,êŒâ™és,73061,36167,36894,70867,35045,35822,7543,3900,3643,40001,20609,19392,23972,10784,13188,12304,5005,7299,1011,402,986,7,47,39,95,58,122,17
R08207,àÔèÈåß,åãèÈés,50645,25441,25204,48248,24029,24219,6065,3109,2956,28719,15068,13651,15388,6963,8425,7497,3147,4350,2057,265,606,2,29,25,75,35,87,11
R08208,àÔèÈåß,ó¥ÉPçËés,76420,37995,38425,73394,36494,36900,8264,4196,4068,44619,22884,21735,22113,10124,11989,10142,4238,5904,1910,359,758,2,45,41,102,55,178,13
R08210,àÔèÈåß,â∫ç»és,42521,21412,21109,40061,20100,19961,5034,2625,2409,24731,12921,11810,12043,5457,6586,5723,2295,3428,1948,248,488,3,26,19,42,25,69,7
R08211,àÔèÈåß,èÌëçés,60834,30465,30369,55681,27724,27957,6942,3554,3388,35001,18417,16584,18316,8119,10197,8851,3493,5358,4755,273,690,3,29,27,60,33,104,14
R08212,àÔèÈåß,èÌó§ëæìcés,48602,23705,24897,48398,23613,24785,4303,2222,2081,25419,12778,12641,18808,8662,10146,9946,4085,5861,174,212,771,4,20,20,39,25,63,11
R08214,àÔèÈåß,çÇîãés,27699,13804,13895,27265,13575,13690,2686,1371,1315,14805,7748,7057,9900,4530,5370,4848,2063,2785,194,150,413,3,17,13,42,16,95,5
R08215,àÔèÈåß,ñkàÔèÈés,41801,20760,21041,41248,20485,20763,4368,2198,2170,22846,11836,11010,14335,6561,7774,6960,2827,4133,341,203,637,3,20,13,40,19,70,5
R08216,àÔèÈåß,ä}ä‘és,73173,35783,37390,71749,35122,36627,8235,4230,4005,40639,20694,19945,23420,10449,12971,11468,4661,6807,672,405,1029,4,39,34,246,49,159,10
R08217,àÔèÈåß,éÊéËés,104524,51476,53048,102280,50389,51891,10593,5474,5119,56760,29042,27718,36052,16262,19790,18209,8018,10191,1392,554,1228,8,54,56,214,72,195,21
R08219,àÔèÈåß,ãçãvés,84651,41773,42878,82372,40609,41763,10834,5474,5360,48124,24379,23745,24561,11226,13335,11816,5301,6515,1373,511,738,2,58,43,192,66,234,17
R08220,àÔèÈåß,Ç¬Ç≠ÇŒés,241656,121043,120613,218039,109774,108265,34645,17810,16835,143552,74058,69494,45697,20759,24938,21691,9059,12632,6556,2133,1733,11,189,133,1353,247,1486,67
R08221,àÔèÈåß,Ç–ÇΩÇøÇ»Ç©és,156581,79293,77288,152689,77178,75511,19610,10080,9530,93439,49116,44323,40234,18125,22109,20700,8985,11715,1578,1050,1436,5,94,70,214,87,278,23
R08222,àÔèÈåß,é≠ìàés,66950,34434,32516,65143,33613,31530,8142,4099,4043,36902,19857,17045,20737,9819,10918,9677,4316,5361,879,449,779,4,38,26,108,44,115,17
R08223,àÔèÈåß,í™óàés,27604,13672,13932,27018,13357,13661,2953,1511,1442,15322,7889,7433,9078,4125,4953,4378,1803,2575,342,148,338,0,12,16,12,20,24,9
R08224,àÔèÈåß,éÁíJés,68421,34163,34258,67001,33583,33418,10301,5321,4980,41920,21235,20685,15847,7464,8383,6590,2951,3639,1127,557,455,3,42,40,126,61,187,16
R08225,àÔèÈåß,èÌó§ëÂã{és,39267,19392,19875,38729,19138,19591,3632,1859,1773,20414,10525,9889,14627,6684,7943,7794,3151,4643,243,161,649,2,23,15,56,21,54,12
R08226,àÔèÈåß,ìﬂâœés,53502,26047,27455,52979,25790,27189,6294,3173,3121,29694,14921,14773,17194,7790,9404,8689,3596,5093,253,302,605,3,32,23,50,27,102,9
R08227,àÔèÈåß,í}êºés,100753,50018,50735,97857,48578,49279,11040,5616,5424,56749,29515,27234,32004,14231,17773,15328,6139,9189,2371,552,1235,5,79,55,148,76,189,23
R08228,àÔèÈåß,ç‚ìåés,52265,26593,25672,49659,25066,24593,5897,2985,2912,30067,16015,14052,15772,7295,8477,7129,2972,4157,2242,251,639,2,25,23,51,37,60,9
R08229,àÔèÈåß,àÓï~és,39039,19490,19549,37869,18863,19006,3393,1749,1644,21055,11081,9974,14329,6484,7845,6878,2713,4165,1022,133,625,1,16,16,33,18,41,5
R08230,àÔèÈåß,Ç©Ç∑Ç›Ç™Ç§ÇÁés,40087,20341,19746,39044,19766,19278,4376,2273,2103,22859,12150,10709,12779,5866,6913,6201,2577,3624,1016,203,538,0,23,15,20,17,25,9
R08231,àÔèÈåß,ç˜êÏés,39122,19359,19763,38722,19152,19570,3985,2100,1885,21579,11235,10344,13423,5933,7490,6491,2474,4017,284,164,558,2,21,21,37,24,42,6
R08232,àÔèÈåß,ê_ê≤és,95454,49407,46047,92441,48036,44405,12569,6411,6158,59856,32296,27560,22162,10100,12062,9868,4009,5859,2656,761,895,4,38,34,86,45,194,25
R08233,àÔèÈåß,çsï˚és,32185,15971,16214,31252,15481,15771,3215,1624,1591,17362,9084,8278,11604,5260,6344,5740,2235,3505,931,157,572,1,16,8,20,10,32,8
R08234,àÔèÈåß,ñgìcés,45953,23376,22577,43157,21678,21479,4647,2387,2260,25268,13529,11739,15454,7203,8251,7396,3114,4282,2474,234,632,2,19,18,25,19,37,8
R08235,àÔèÈåß,Ç¬Ç≠ÇŒÇ›ÇÁÇ¢és,49872,24895,24977,47623,23781,23842,7350,3798,3552,27180,13914,13266,13152,5988,7164,6206,2722,3484,424,428,455,0,22,23,24,30,63,17
R08236,àÔèÈåß,è¨î¸ã és,48870,24591,24279,47248,23701,23547,5631,2866,2765,28053,14738,13315,14724,6729,7995,7184,3000,4184,1300,287,629,4,19,14,42,18,48,12
R08302,àÔèÈåß,àÔèÈí¨,31401,15563,15838,30780,15216,15564,3271,1716,1555,17040,8870,8170,10983,4920,6063,5431,2189,3242,547,155,417,2,18,14,138,19,73,7
R08309,àÔèÈåß,ëÂêÙí¨,15715,7789,7926,14894,7372,7522,1538,780,758,8766,4650,4116,5225,2248,2977,2644,1002,1642,704,71,269,1,9,7,14,8,27,4
R08310,àÔèÈåß,èÈó¢í¨,18097,8913,9184,18027,8892,9135,1559,834,725,9746,4949,4797,6774,3119,3655,3388,1353,2035,66,73,313,1,9,7,10,8,16,4
R08341,àÔèÈåß,ìåäCë∫,37891,19240,18651,37289,18898,18391,5399,2816,2583,22581,11874,10707,9517,4307,5210,5115,2290,2825,285,250,352,2,16,13,46,17,70,10
R08364,àÔèÈåß,ëÂéqí¨,15736,7692,8044,15654,7669,7985,1183,628,555,7262,3810,3452,7266,3243,4023,3935,1527,2408,82,46,354,2,5,5,18,5,20,5
R08442,àÔèÈåß,î¸âYë∫,14602,7479,7123,14283,7345,6938,1472,764,708,8425,4597,3828,4677,2108,2569,2258,905,1353,303,76,192,1,4,5,12,7,20,2
R08443,àÔèÈåß,à¢å©í¨,48553,24237,24316,46989,23468,23521,5983,3067,2916,28352,14624,13728,13360,6018,7342,6370,2638,3732,865,295,538,2,24,29,168,43,199,8
R08447,àÔèÈåß,âÕì‡í¨,8231,4051,4180,8124,4007,4117,589,303,286,4409,2299,2110,3227,1445,1782,1722,671,1051,107,37,140,0,3,2,0,3,1,2
R08521,àÔèÈåß,î™êÁë„í¨,21026,10991,10035,19907,10075,9832,2369,1238,1131,12114,6723,5391,6459,2966,3493,3030,1231,1799,1073,115,264,1,5,9,7,11,17,6
R08542,àÔèÈåß,å‹â‡í¨,8093,4066,4027,7948,3986,3962,730,379,351,4544,2341,2203,2732,1325,1407,1137,482,655,145,24,128,0,3,2,1,3,15,2
R08546,àÔèÈåß,ã´í¨,24201,12274,11927,23274,11721,11553,2912,1434,1478,14152,7531,6621,7018,3225,3793,3230,1346,1884,896,140,329,1,12,13,94,17,71,6
R08564,àÔèÈåß,óòç™í¨,15340,7482,7858,15099,7365,7734,1196,603,593,7227,3725,3502,6903,3148,3755,3255,1496,1759,240,33,209,0,9,4,10,6,10,3
R09201,ì»ñÿåß,âFìsã{és,518757,259616,259141,496912,248770,248142,65253,33320,31933,307157,159790,147367,129853,57282,72571,63423,25554,37869,8003,3731,4828,25,430,308,1124,444,1296,96
R09202,ì»ñÿåß,ë´óòés,144746,71405,73341,139706,68622,71084,15176,7661,7515,80642,41740,38902,47023,20759,26264,23932,9672,14260,4518,675,1916,9,109,82,302,115,327,33
R09203,ì»ñÿåß,ì»ñÿés,155549,77408,78141,150874,74702,76172,17322,8988,8334,87866,45588,42278,49179,22059,27120,23799,9637,14162,3834,842,1992,5,126,78,198,95,275,29
R09204,ì»ñÿåß,ç≤ñÏés,116228,57494,58734,112432,55677,56755,13011,6718,6293,66171,34286,31885,35621,15801,19820,17437,6808,10629,2690,651,1499,3,97,62,204,79,232,26
R09205,ì»ñÿåß,é≠è¿és,94033,46609,47424,92323,45666,46657,11015,5693,5322,53951,27787,26164,28504,12741,15763,13817,5533,8284,1372,546,1160,2,67,47,158,74,158,21
R09206,ì»ñÿåß,ì˙åıés,77661,37823,39838,76360,37274,39086,7410,3901,3509,41644,21297,20347,27850,12186,15664,14310,5510,8800,836,365,1183,7,52,41,121,43,148,19
R09208,ì»ñÿåß,è¨éRés,166666,84450,82216,158423,80172,78251,20940,11005,9935,101109,52963,48146,41781,19008,22773,19633,8023,11610,6034,1180,1574,7,122,78,244,114,333,47
R09209,ì»ñÿåß,ê^â™és,78190,39482,38708,74451,37646,36805,10200,5189,5011,45955,24033,21922,21215,9758,11457,9535,3933,5602,3146,498,815,3,66,32,162,44,184,18
R09210,ì»ñÿåß,ëÂìcå¥és,72087,35407,36680,69751,34352,35399,8176,4111,4065,41342,21135,20207,20726,9289,11437,9634,3768,5866,1010,421,860,4,51,24,167,35,204,14
R09211,ì»ñÿåß,ñÓî¬és,31165,15415,15750,30762,15238,15524,3244,1708,1536,17357,8908,8449,10334,4636,5698,4939,1981,2958,291,152,403,2,19,15,63,19,65,11
R09213,ì»ñÿåß,ìﬂê{âñå¥és,115210,57307,57903,111407,55400,56007,14265,7394,6871,66620,34138,32482,32020,14463,17557,14895,6135,8760,1855,730,1176,6,63,51,250,74,207,31
R09214,ì»ñÿåß,Ç≥Ç≠ÇÁés,44513,23102,21411,44114,22892,21222,6015,3079,2936,26570,14566,12004,11734,5321,6413,5661,2296,3365,381,322,459,1,30,16,41,19,58,11
R09215,ì»ñÿåß,ìﬂê{âGéRés,24875,12379,12496,24648,12273,12375,2369,1232,1137,13175,6924,6251,9331,4223,5108,4724,1872,2852,227,75,459,1,17,12,32,14,27,5
R09216,ì»ñÿåß,â∫ñÏés,59507,29453,30054,57018,28336,28682,7009,3641,3368,34829,17418,17411,14912,6836,8076,7062,2936,4126,599,396,559,3,61,25,908,63,325,14
R09301,ì»ñÿåß,è„éOêÏí¨,30806,15842,14964,30236,15522,14714,4073,2084,1989,18972,9958,9014,7262,3411,3851,3282,1412,1870,333,227,255,1,19,10,28,12,53,7
R09342,ì»ñÿåß,âvéqí¨,21898,10871,11027,21586,10750,10836,2467,1258,1209,12195,6258,5937,7041,3258,3783,3040,1247,1793,189,80,281,1,12,11,18,21,14,7
R09343,ì»ñÿåß,ñŒñÿí¨,11891,5872,6019,11787,5836,5951,986,527,459,5810,3024,2786,5073,2308,2765,2592,1032,1560,94,27,217,0,9,5,6,5,5,5
R09344,ì»ñÿåß,ésäLí¨,11262,5756,5506,11076,5667,5409,1269,638,631,6568,3490,3078,3317,1561,1756,1491,599,892,173,55,138,1,6,5,8,6,28,5
R09345,ì»ñÿåß,ñFâÍí¨,14961,7541,7420,14767,7461,7306,1942,1019,923,8179,4268,3911,4782,2217,2565,2178,899,1279,159,74,210,0,10,7,11,10,18,5
R09361,ì»ñÿåß,êpê∂í¨,39474,19442,20032,38640,18941,19699,4680,2411,2269,22578,11326,11252,11443,5179,6264,5491,2281,3210,503,213,407,1,37,15,663,49,181,9
R09364,ì»ñÿåß,ñÏñÿí¨,24913,12401,12512,24588,12216,12372,2908,1528,1380,13897,7032,6865,8095,3829,4266,3463,1506,1957,325,158,252,2,12,8,23,10,151,3
R09384,ì»ñÿåß,âñíJí¨,10354,5135,5219,10299,5119,5180,914,480,434,5282,2772,2510,4157,1882,2275,2044,790,1254,53,33,180,0,7,6,5,11,4,3
R09386,ì»ñÿåß,çÇç™ëÚí¨,29229,15254,13975,28516,14932,13584,3471,1872,1599,18001,9926,8075,7409,3313,4096,3630,1376,2254,398,220,279,2,15,12,21,14,31,7
R09407,ì»ñÿåß,ìﬂê{í¨,23956,11784,12172,23513,11597,11916,2154,1122,1032,11866,6048,5818,9690,4482,5208,4598,1848,2750,242,76,361,0,13,7,9,9,8,7
R09411,ì»ñÿåß,ìﬂâœêÏí¨,15215,7682,7533,15067,7627,7440,1284,652,632,7875,4175,3700,6029,2832,3197,3028,1243,1785,143,61,239,1,8,5,7,8,18,3
R10201,åQînåß,ëOã¥és,332149,162298,169851,315078,154047,161031,36764,18891,17873,179561,90203,89358,96390,42199,54191,49956,19933,30023,5505,2191,3850,18,337,201,1580,315,943,78
R10202,åQînåß,çÇçËés,372973,182646,190327,363518,178526,184992,46009,23589,22420,215425,109564,105861,105034,46109,58925,54212,21755,32457,5077,2525,4081,25,349,202,858,298,902,93
R10203,åQînåß,ãÀê∂és,106445,51392,55053,104389,50463,53926,9973,5129,4844,57199,29309,27890,38392,16402,21990,20621,8016,12605,1579,429,1677,7,98,78,202,107,227,30
R10204,åQînåß,à…ê®çËés,211850,106350,105500,197596,98939,98657,27506,13936,13570,127686,66629,61057,53086,23751,29335,26491,10911,15580,11955,1473,2162,8,150,98,426,129,415,45
R10205,åQînåß,ëæìcés,223014,114106,108908,209319,106391,102928,29597,15142,14455,131786,70589,61197,58057,26226,31831,28336,11879,16457,10992,1520,2247,9,152,111,416,185,439,51
R10206,åQînåß,è¿ìcés,45337,21942,23395,44569,21601,22968,4787,2468,2319,24666,12481,12185,15489,6786,8703,8152,3137,5015,522,220,661,4,42,23,139,34,103,11
R10207,åQînåß,äŸó—és,75309,37769,37540,72280,36164,36116,8494,4345,4149,44000,23153,20847,22103,9807,12296,10913,4336,6577,2425,379,908,5,52,42,166,56,169,16
R10208,åQînåß,èaêÏés,74581,36363,38218,73575,35945,37630,7561,3803,3758,40199,20571,19628,26284,11676,14608,13324,5269,8055,709,352,1088,6,52,31,219,45,144,13
R10209,åQînåß,ì°â™és,63261,30766,32495,62213,30262,31951,6837,3414,3423,35533,18012,17521,20486,9078,11408,10198,4116,6082,727,333,789,5,44,29,161,40,161,25
R10210,åQînåß,ïxâ™és,47446,23403,24043,46598,23054,23544,5077,2608,2469,25762,13215,12547,16334,7426,8908,8446,3502,4944,797,211,751,3,41,17,138,28,101,16
R10211,åQînåß,à¿íÜés,54907,26848,28059,54185,26513,27672,5510,2840,2670,29336,14942,14394,19753,8875,10878,10054,4116,5938,477,252,836,5,37,22,76,33,82,15
R10212,åQînåß,Ç›Ç«ÇËés,49648,24562,25086,48806,24141,24665,5904,3037,2867,28254,14565,13689,14832,6606,8226,7285,2900,4385,684,299,596,4,34,20,103,25,100,11
R10344,åQînåß,êYìåë∫,14216,7190,7026,14024,7102,6922,1886,996,890,8497,4451,4046,3776,1710,2066,1770,717,1053,158,107,145,0,5,4,5,3,6,3
R10345,åQînåß,ãgâ™í¨,21792,10613,11179,21600,10528,11072,3394,1703,1691,13135,6509,6626,5212,2367,2845,2473,1024,1449,148,201,190,1,15,9,33,12,40,5
R10366,åQînåß,è„ñÏë∫,1128,573,555,1111,573,538,108,59,49,502,269,233,518,245,273,315,137,178,17,4,24,0,1,1,1,0,0,0
R10367,åQînåß,ê_ó¨í¨,1645,793,852,1634,790,844,59,28,31,575,319,256,1011,446,565,610,233,377,11,3,51,0,3,1,2,1,3,1
R10382,åQînåß,â∫êmìcí¨,6576,3224,3352,6545,3216,3329,352,172,180,2884,1510,1374,3340,1542,1798,1914,804,1110,31,15,179,1,4,2,11,4,16,2
R10383,åQînåß,ìÏñqë∫,1611,762,849,1606,759,847,38,24,14,522,278,244,1051,460,591,703,279,424,5,5,60,0,2,1,0,0,0,1
R10384,åQînåß,ä√äyí¨,12491,6175,6316,12323,6077,6246,1276,660,616,6643,3355,3288,4274,1993,2281,2044,847,1197,154,63,197,0,12,8,12,8,8,1
R10421,åQînåß,íÜîVèí¨,15386,7498,7888,15153,7386,7767,1365,717,648,7654,3901,3753,6294,2826,3468,3512,1438,2074,196,72,275,3,14,6,27,9,25,3
R10424,åQînåß,í∑ñÏå¥í¨,5095,2529,2566,5034,2496,2538,434,235,199,2621,1393,1228,1991,873,1118,1039,414,625,59,24,83,2,4,1,12,1,11,0
R10425,åQînåß,í⁄óˆë∫,8850,4522,4328,8698,4407,4291,915,483,432,4635,2529,2106,3285,1498,1787,1683,700,983,143,32,141,0,3,3,2,3,5,1
R10426,åQînåß,ëêí√í¨,6049,3034,3015,5701,2877,2824,435,224,211,2882,1554,1328,2348,1040,1308,1265,519,746,223,20,93,2,3,3,9,4,7,1
R10428,åQînåß,çÇéRë∫,3511,1745,1766,3318,1620,1698,354,188,166,1858,967,891,1299,590,709,707,286,421,193,19,71,0,4,1,3,1,2,0
R10429,åQînåß,ìåå·ç»í¨,12728,6268,6460,12483,6173,6310,1078,557,521,6379,3302,3077,5253,2395,2858,2720,1118,1602,240,50,216,1,7,4,26,5,21,2
R10443,åQînåß,ï–ïië∫,3993,1949,2044,3943,1919,2024,331,159,172,2001,1051,950,1639,725,914,824,304,520,42,20,75,0,2,1,2,0,1,3
R10444,åQînåß,êÏèÍë∫,3480,1593,1887,3470,1589,1881,361,188,173,1553,781,772,1566,624,942,978,321,657,10,12,43,1,3,1,8,2,6,1
R10448,åQînåß,è∫òaë∫,6953,3455,3498,6517,3266,3251,799,446,353,3869,1946,1923,2281,1061,1220,1071,425,646,436,37,104,0,2,1,1,0,0,3
R10449,åQînåß,Ç›Ç»Ç©Ç›í¨,17195,8349,8846,16959,8229,8730,1500,773,727,8653,4426,4227,7014,3128,3886,3704,1424,2280,222,64,312,2,7,7,14,8,16,3
R10464,åQînåß,ã ë∫í¨,36054,17594,18460,34289,16795,17494,3777,1954,1823,20898,10260,10638,9207,4249,4958,3986,1649,2337,834,231,311,1,21,14,28,17,39,8
R10521,åQînåß,î¬ëqí¨,14083,7031,7052,13691,6842,6849,1361,697,664,7812,4035,3777,4735,2197,2538,2070,844,1226,257,44,192,0,8,6,9,6,18,3
R10522,åQînåß,ñæòaí¨,10882,5465,5417,10590,5328,5262,1284,672,612,6202,3189,3013,3316,1546,1770,1514,633,881,241,47,130,0,5,3,4,3,5,1
R10523,åQînåß,êÁë„ìcí¨,10861,5470,5391,10468,5293,5175,1257,680,577,6215,3224,2991,3374,1554,1820,1511,642,869,337,61,132,0,5,4,4,5,39,2
R10524,åQînåß,ëÂêÚí¨,42089,22282,19807,34140,18120,16020,5097,2592,2505,26575,14773,11802,9464,4335,5129,4389,1867,2522,7392,213,316,1,24,15,23,24,49,8
R10525,åQînåß,óWäyí¨,25522,12852,12670,24790,12460,12330,2824,1458,1366,14259,7449,6810,8241,3815,4426,3665,1611,2054,634,132,300,1,18,9,15,10,27,4
R11100,çÈã åß,Ç≥Ç¢ÇΩÇ‹és,1324025,652920,671105,1276491,630173,646318,168805,86414,82391,821211,416997,404214,304992,135350,169642,158215,64888,93327,22845,10006,11219,35,981,690,2720,1054,3744,248
R11201,çÈã åß,êÏâzés,354571,177480,177091,323232,164161,159071,36460,18703,17757,181655,92689,88966,89061,40124,48937,44727,19323,25404,5909,2314,3380,20,208,184,948,304,1034,63
R11202,çÈã åß,åFíJés,194415,97087,97328,189946,94969,94977,21814,11224,10590,113744,59350,54394,57262,25737,31525,27885,11363,16522,3076,1117,2300,10,151,105,355,148,473,40
R11203,çÈã åß,êÏå˚és,594274,299238,295036,555098,279135,275963,72665,37212,35453,373347,194020,179327,137923,61595,76328,71165,29061,42104,31592,3969,5697,19,326,280,895,375,1069,123
R11206,çÈã åß,çsìcés,78617,38736,39881,76691,37803,38888,8240,4151,4089,44778,23104,21674,25010,11209,13801,11842,4784,7058,1417,371,934,2,38,41,105,52,151,12
R11207,çÈã åß,íÅïÉés,59674,29068,30606,58967,28767,30200,6590,3335,3255,32459,16610,15849,20342,8939,11403,10737,4232,6505,511,336,902,5,61,30,105,54,100,18
R11208,çÈã åß,èäëÚés,342464,168197,174267,311495,156622,154873,33050,16969,16081,174266,86788,87478,87050,38962,48088,44271,18905,25366,3865,2162,3277,21,223,163,954,237,759,62
R11209,çÈã åß,î—î\és,80361,40294,40067,78588,39382,39206,8424,4363,4061,45590,23587,22003,25204,11664,13540,12081,5077,7004,929,432,909,4,46,37,76,48,119,16
R11210,çÈã åß,â¡ê{és,111623,55982,55641,108900,54587,54313,12547,6521,6026,64960,33591,31369,33283,15442,17841,14887,6168,8719,2142,546,1250,4,54,51,90,69,166,22
R11211,çÈã åß,ñ{èØés,78569,39216,39353,75074,37358,37716,8894,4447,4447,45696,23856,21840,22661,10103,12558,11201,4504,6697,2403,411,915,10,55,44,125,56,169,23
R11212,çÈã åß,ìåèºéRés,91791,46187,45604,87453,43979,43474,10582,5424,5158,52871,27444,25427,25995,12105,13890,12075,5231,6844,2454,531,909,6,61,54,156,69,215,17
R11214,çÈã åß,ètì˙ïîés,229792,113467,116325,225799,111498,114301,21178,10917,10261,116707,58934,57773,68663,30872,37791,34219,14997,19222,3442,1265,2529,12,123,115,374,165,512,34
R11215,çÈã åß,ã∑éRés,148699,74178,74521,145231,72421,72810,15467,7906,7561,84070,43670,40400,47661,21642,26019,24050,10425,13625,2327,796,1566,9,77,72,324,107,347,27
R11216,çÈã åß,âHê∂és,52862,26142,26720,49849,24786,25063,5295,2667,2628,29391,15110,14281,15821,7204,8617,7491,3083,4408,1210,248,601,2,33,26,106,39,119,10
R11217,çÈã åß,çÉëÉés,116828,57673,59155,114669,56543,58126,13254,6795,6459,67954,34434,33520,34993,16048,18945,16491,7091,9400,1611,667,1156,3,68,59,110,78,200,19
R11218,çÈã åß,ê[íJés,141268,70200,71068,137413,68297,69116,16815,8572,8243,81390,42073,39317,40881,18620,22261,19303,8076,11227,2611,869,1664,8,92,64,242,84,261,38
R11219,çÈã åß,è„îˆés,226940,112288,114652,217223,108149,109074,25395,13078,12317,127746,64559,63187,61216,27452,33764,31705,13653,18052,3225,1439,2135,4,119,92,436,179,522,39
R11221,çÈã åß,ëêâ¡és,248304,125213,123091,241115,121722,119393,29088,14982,14106,157501,82508,74993,61664,27692,33972,31840,13551,18289,7147,1459,2108,6,128,122,313,184,387,39
R11222,çÈã åß,âzíJés,341621,168747,172874,334953,165526,169427,43497,22267,21230,210444,107119,103325,87123,38985,48138,44440,18959,25481,6547,2381,3023,12,184,169,855,263,859,47
R11223,çÈã åß,ònés,74283,37470,36813,67534,34036,33498,7885,4065,3820,48527,25434,23093,17247,7580,9667,9028,3540,5488,6293,492,701,3,47,37,72,59,135,14
R11224,çÈã åß,åÀìcés,140899,71388,69511,131679,67112,64567,20025,10168,9857,93035,48316,44719,23065,10552,12513,11548,4623,6925,5870,1205,945,5,90,64,277,116,274,44
R11225,çÈã åß,ì¸ä‘és,145651,71803,73848,143118,70495,72623,16610,8476,8134,85174,43264,41910,42924,19506,23418,20704,8770,11934,2023,745,1427,7,66,66,129,100,224,25
R11227,çÈã åß,í©â‡és,141083,70696,70387,136913,68622,68291,19106,9711,9395,93817,48307,45510,27533,12297,15236,14237,5737,8500,3578,1251,1022,3,77,69,210,96,289,44
R11228,çÈã åß,éuñÿés,75346,36945,38401,73293,36019,37274,9897,5077,4820,46217,23397,22820,18689,8222,10467,9673,4020,5653,1613,563,649,2,40,32,54,46,127,25
R11229,çÈã åß,òaåıés,83989,43138,40851,81671,41922,39749,11397,5860,5537,57416,30409,27007,15040,6824,8216,7308,3029,4279,2215,748,524,4,35,31,286,64,188,19
R11230,çÈã åß,êVç¿és,166017,81781,84236,159171,78712,80459,20924,10611,10313,98647,50543,48104,42180,18732,23448,22235,9339,12896,2985,1029,1481,6,67,58,197,87,290,36
R11231,çÈã åß,â±êÏés,74748,36950,37798,73642,36328,37314,8611,4433,4178,43586,22221,21365,22126,10010,12116,11459,4934,6525,764,422,764,2,47,32,65,61,96,13
R11232,çÈã åß,ãväÏés,150582,74607,75975,146370,72746,73624,16537,8466,8071,86097,44137,41960,46097,21260,24837,21374,9246,12128,2655,837,1616,6,84,92,287,137,345,25
R11233,çÈã åß,ñkñ{és,65201,32214,32987,64404,31794,32610,6593,3357,3236,37112,18900,18212,21183,9732,11451,10876,4838,6038,514,359,722,2,42,37,158,44,182,10
R11234,çÈã åß,î™í™és,93363,47995,45368,87987,45438,42549,11335,5796,5539,58742,31557,27185,21283,9754,11529,10855,4708,6147,3461,799,780,3,42,38,92,67,131,20
R11235,çÈã åß,ïxémå©és,111859,54871,56988,107437,52657,54780,13657,6999,6658,68450,34307,34143,27171,12095,15076,14308,6030,8278,1998,805,1023,5,63,57,168,87,233,22
R11237,çÈã åß,éOãΩés,142145,71486,70659,136429,68414,68015,18162,9217,8945,83860,43426,40434,38602,17883,20719,18135,8050,10085,4309,1044,1276,6,68,61,205,84,356,27
R11238,çÈã åß,ò@ìcés,61499,30468,31031,60884,30162,30722,6739,3443,3296,34826,17941,16885,19902,9062,10840,10290,4486,5804,606,351,648,3,34,29,106,43,164,10
R11239,çÈã åß,ç‚åÀés,100275,50041,50234,96386,48054,48332,11428,5760,5668,57702,29940,27762,29435,13398,16037,14409,6448,7961,2296,525,1002,5,66,52,97,336,251,14
R11240,çÈã åß,çKéËés,50066,24979,25087,48820,24367,24453,4917,2552,2365,27131,14094,13037,17633,8145,9488,8381,3702,4679,979,210,600,5,31,30,92,42,105,6
R11241,çÈã åß,íﬂÉñìáés,70117,34585,35532,68440,33723,34717,7872,3990,3882,41523,20967,20556,20241,9308,10933,9460,4249,5211,1281,402,664,2,40,30,80,49,153,13
R11242,çÈã åß,ì˙çÇés,54571,26953,27618,53715,26605,27110,6286,3158,3128,30041,15339,14702,17966,8319,9647,8389,3791,4598,784,261,588,3,21,20,355,40,147,10
R11243,çÈã åß,ãgêÏés,71979,35800,36179,70375,35019,35356,10383,5330,5053,44153,22486,21667,17315,7893,9422,7979,3477,4502,1558,581,571,1,39,34,67,51,107,15
R11245,çÈã åß,Ç”Ç∂Ç›ñÏés,113597,56085,57512,109942,54169,55773,14377,7274,7103,68512,35152,33360,29317,12817,16500,16088,6622,9466,2561,735,1005,3,69,50,120,69,205,22
R11246,çÈã åß,îíâ™és,52214,25764,26450,51492,25420,26072,6495,3284,3211,30722,15665,15057,14597,6631,7966,7355,3126,4229,535,407,488,3,30,25,71,32,110,7
R11301,çÈã åß,à…ìﬁí¨,44841,22539,22302,43975,22043,21932,6227,3189,3038,27222,14157,13065,10920,4911,6009,5518,2419,3099,398,236,352,4,17,15,200,28,177,9
R11324,çÈã åß,éOñFí¨,38434,18949,19485,37638,18561,19077,4634,2391,2243,22185,11395,10790,11530,5127,6403,6243,2661,3582,717,215,369,3,14,11,74,17,108,5
R11326,çÈã åß,ñ—òCéRí¨,35366,17534,17832,34293,17085,17208,2960,1520,1440,19956,10289,9667,11594,5318,6276,5727,2545,3182,523,108,400,3,16,16,547,50,178,7
R11327,çÈã åß,âzê∂í¨,11029,5494,5535,10876,5425,5451,933,472,461,6055,3123,2932,3984,1863,2121,1908,790,1118,124,41,173,0,7,4,6,4,11,2
R11341,çÈã åß,ääêÏí¨,19732,10070,9662,19058,9709,9349,3063,1559,1504,11854,6229,5625,4611,2168,2443,2121,915,1206,476,167,161,0,7,10,15,18,26,6
R11342,çÈã åß,óíéRí¨,17889,8941,8948,17258,8634,8624,1665,853,812,10248,5344,4904,5868,2690,3178,2792,1182,1610,569,70,197,1,10,9,14,16,18,4
R11343,çÈã åß,è¨êÏí¨,28524,14190,14334,28189,14011,14178,2287,1163,1124,15045,7771,7274,11093,5199,5894,5060,2130,2930,269,97,427,3,26,17,67,21,79,6
R11346,çÈã åß,êÏìáí¨,19378,9823,9555,19018,9652,9366,1804,945,859,10545,5532,5013,6970,3299,3671,3066,1303,1763,333,73,235,1,12,9,18,11,19,2
R11347,çÈã åß,ãgå©í¨,18192,9127,9065,18008,9041,8967,1526,799,727,10488,5394,5094,6146,2912,3234,2647,1141,1506,154,64,231,0,6,6,9,8,51,1
R11348,çÈã åß,îµéRí¨,13560,6556,7004,13420,6502,6918,942,449,493,6383,3223,3160,6226,2878,3348,3070,1388,1682,133,32,191,1,5,6,11,6,15,2
R11349,çÈã åß,Ç∆Ç´Ç™ÇÌí¨,10540,5333,5207,10364,5212,5152,880,441,439,5568,2960,2608,4092,1932,2160,1888,810,1078,176,28,150,0,7,4,4,4,6,3
R11361,çÈã åß,â°ê£í¨,7979,3966,4013,7905,3942,3963,845,419,426,4403,2280,2123,2713,1256,1457,1390,572,818,63,36,129,0,4,2,3,3,3,2
R11362,çÈã åß,äFñÏí¨,9302,4583,4719,9218,4544,4674,936,496,440,4756,2436,2320,3578,1632,1946,1825,745,1080,62,48,160,2,7,6,12,10,20,2
R11363,çÈã åß,í∑ì“í¨,6807,3321,3486,6781,3308,3473,624,318,306,3481,1783,1698,2697,1217,1480,1468,611,857,24,24,106,0,5,3,6,3,6,2
R11365,çÈã åß,è¨é≠ñÏí¨,10928,5382,5546,10821,5331,5490,1038,529,509,5624,2921,2703,4248,1922,2326,2181,866,1315,100,39,188,1,10,6,16,8,17,3
R11369,çÈã åß,ìåíÅïÉë∫,2709,1352,1357,2700,1350,1350,173,84,89,1275,658,617,1261,610,651,670,284,386,9,7,43,0,1,0,2,0,0,1
R11381,çÈã åß,î¸ó¢í¨,11039,5540,5499,10882,5437,5445,1159,594,565,6121,3238,2883,3720,1681,2039,1857,748,1109,137,40,179,0,7,5,5,6,22,4
R11383,çÈã åß,ê_êÏí¨,13359,6755,6604,12921,6530,6391,1354,691,663,7480,3901,3579,4381,2073,2308,2091,877,1214,346,51,212,0,8,4,5,5,26,3
R11385,çÈã åß,è„ó¢í¨,30343,15012,15331,28181,14004,14177,3384,1729,1655,17011,8580,8431,8322,3779,4543,3745,1576,2169,945,170,355,0,22,12,17,13,42,7
R11408,çÈã åß,äÒãèí¨,32374,16053,16321,31858,15814,16044,3219,1648,1571,18169,9413,8756,10904,4932,5972,5303,2169,3134,509,183,398,2,22,17,31,28,40,7
R11442,çÈã åß,ã{ë„í¨,34147,17182,16965,33353,16800,16553,3711,1892,1819,18897,9949,8948,10974,5034,5940,5706,2556,3150,385,206,385,0,16,11,16,12,48,5
R11464,çÈã åß,êôåÀí¨,43845,21927,21918,43138,21600,21538,4655,2411,2244,24567,12728,11839,14406,6696,7710,6930,3139,3791,519,176,455,1,20,17,25,18,62,6
R11465,çÈã åß,èºïöí¨,28266,14208,14058,27935,14046,13889,3069,1605,1464,16785,8711,8074,8405,3886,4519,3964,1726,2238,327,127,292,3,8,10,24,11,78,5
R12100,êÁótåß,êÁótés,974951,481246,493705,920287,455073,465214,110929,56863,54066,569887,289316,280571,249963,111731,138232,130246,55099,75147,23142,5976,9352,40,710,548,2992,914,2822,215
R12202,êÁótåß,í∂éqés,58431,28248,30183,56057,27064,28993,4470,2251,2219,31241,16097,15144,22053,9483,12570,11615,4344,7271,2137,186,957,5,34,41,77,47,158,11
R12203,êÁótåß,ésêÏés,496676,251351,245325,470504,237638,232866,57265,29323,27942,323110,168695,154415,103359,45560,57799,51819,21044,30775,15899,3847,3798,11,269,219,738,387,955,136
R12204,êÁótåß,ëDã¥és,642907,318860,324047,615289,305831,309458,80576,41408,39168,396514,203988,192526,152773,67299,85474,81154,33934,47220,16915,4458,5578,19,358,314,1002,486,1672,124
R12205,êÁótåß,äŸéRés,45153,21846,23307,43913,21290,22623,4121,2172,1949,21071,10657,10414,17734,7706,10028,9387,3687,5700,284,237,691,4,42,24,127,43,122,10
R12206,êÁótåß,ñÿçXí√és,136166,68450,67716,131959,66649,65310,17144,8782,8362,79146,41564,37582,37370,16818,20552,18834,7941,10893,2266,980,1416,10,95,63,337,105,302,17
R12207,êÁótåß,èºåÀés,498232,247210,251022,476848,236451,240397,56850,29204,27646,305487,156709,148778,127595,56220,71375,66846,27590,39256,15513,3272,4717,18,278,269,900,737,1327,73
R12208,êÁótåß,ñÏìcés,152638,76195,76443,147915,73918,73997,17426,8984,8442,86231,44995,41236,47051,21315,25736,22533,9722,12811,3163,811,1663,5,77,81,208,117,343,22
R12210,êÁótåß,ñŒå¥és,86782,42643,44139,84512,41727,42785,8635,4430,4205,47894,24401,23493,28774,13077,15697,14231,6037,8194,1166,435,1101,7,62,57,121,87,248,11
R12211,êÁótåß,ê¨ìcés,132906,66231,66675,125185,62272,62913,16794,8639,8155,81731,41602,40129,31352,14274,17078,14718,5993,8725,5165,851,1106,5,87,66,527,96,384,29
R12212,êÁótåß,ç≤ëqés,168743,82421,86322,165043,80759,84284,18589,9613,8976,94196,47217,46979,55000,25157,29843,26728,11837,14891,3065,754,1705,6,117,87,459,109,474,34
R12213,êÁótåß,ìåã‡és,58219,29251,28968,55979,28112,27867,6040,3077,2963,33761,17538,16223,17163,7896,9267,7862,3279,4583,1371,305,637,2,38,27,130,51,137,7
R12215,êÁótåß,àÆés,63745,31379,32366,62151,30537,31614,7170,3646,3524,36134,18635,17499,19843,8710,11133,9594,3625,5969,1320,396,839,3,37,34,306,52,163,18
R12216,êÁótåß,èKéuñÏés,176197,87882,88315,170458,85295,85163,22186,11318,10868,111019,57522,53497,40483,17746,22737,21093,8685,12408,4034,1287,1403,5,107,102,365,155,475,27
R12217,êÁótåß,îêés,426468,210824,215644,407361,200646,206715,53333,27178,26155,251739,127936,123803,110212,49184,61028,55141,23414,31727,7882,3093,3767,16,255,215,1181,318,1126,77
R12218,êÁótåß,èüâYés,16927,8704,8223,16756,8610,8146,1145,581,564,8357,4796,3561,7290,3215,4075,3956,1544,2412,165,54,336,1,11,7,30,19,36,3
R12219,êÁótåß,éså¥és,269524,138438,131086,259640,133522,126118,30046,15460,14586,154641,82219,72422,78661,36924,41737,37830,16382,21448,5044,1587,2957,11,157,125,518,168,554,27
R12220,êÁótåß,ó¨éRés,199849,98431,101418,194858,96088,98770,31172,15894,15278,118860,59995,58865,46047,20640,25407,23574,10293,13281,2745,2027,1485,6,109,98,235,150,356,59
R12221,êÁótåß,î™êÁë„és,199498,97920,101578,193727,95236,98491,25580,13162,12418,122780,61930,60850,50490,22415,28075,27054,11505,15549,5367,1407,1758,6,126,113,421,160,450,34
R12222,êÁótåß,â‰ë∑éqés,130510,63546,66964,127855,62368,65487,14296,7358,6938,74457,37732,36725,39879,17638,22241,21221,9187,12034,1623,748,1357,8,71,69,144,107,248,23
R12223,êÁótåß,äõêÏés,32116,15224,16892,31548,15006,16542,2991,1561,1430,16205,7852,8353,12375,5509,6866,6720,2755,3965,507,189,529,6,17,11,443,45,151,7
R12224,êÁótåß,äôÉPíJés,109932,53592,56340,106876,52240,54636,12558,6354,6204,63683,32360,31323,31488,13988,17500,16317,6978,9339,1488,689,1009,5,65,62,170,97,243,12
R12225,êÁótåß,åNí√és,82206,41928,40278,80285,41016,39269,8427,4347,4080,45829,24783,21046,26366,11805,14561,13513,5450,8063,718,458,1029,4,47,34,85,41,133,16
R12226,êÁótåß,ïxí√és,42465,21529,20936,41532,21081,20451,3665,1908,1757,21976,11946,10030,16118,7310,8808,8320,3368,4952,453,134,693,3,27,21,34,28,52,11
R12227,êÁótåß,âYà¿és,171362,83506,87856,164767,79942,84825,21564,11055,10509,116855,56964,59891,29971,13692,16279,13479,5868,7611,3691,1179,934,6,89,77,692,154,381,40
R12228,êÁótåß,éläXìπés,93576,46347,47229,90549,44802,45747,12477,6536,5941,53027,27166,25861,27066,12240,14826,14191,6435,7756,2054,688,863,4,49,45,120,60,175,17
R12229,êÁótåß,ë≥ÉPâYés,63883,32214,31669,62361,31435,30926,8622,4340,4282,37221,19369,17852,17057,7929,9128,7779,3375,4404,668,545,601,1,42,24,70,44,106,12
R12230,êÁótåß,î™äXés,67455,34113,33342,64693,32815,31878,6273,3204,3069,39431,20643,18788,20912,9858,11054,9145,3914,5231,2105,258,782,3,26,32,42,36,84,9
R12231,êÁótåß,àÛêºés,102609,50574,52035,100332,49531,50801,16789,8527,8262,61663,30461,31202,23698,11293,12405,9689,4110,5579,1956,853,774,2,48,40,281,57,227,30
R12232,êÁótåß,îíà‰és,62441,30916,31525,60845,30079,30766,8616,4376,4240,36076,18313,17763,17101,7891,9210,8069,3552,4517,1117,311,515,3,30,29,75,38,118,9
R12233,êÁótåß,ïxó¢és,49735,25303,24432,46654,23686,22968,5381,2766,2615,29894,15562,14332,14035,6716,7319,5771,2610,3161,2751,259,426,2,22,23,49,25,77,6
R12234,êÁótåß,ìÏñ[ëçés,35831,17011,18820,35441,16909,18532,3001,1482,1519,15867,8053,7814,16895,7435,9460,9236,3600,5636,362,105,712,3,23,14,33,19,45,9
R12235,êÁótåß,ëxç∫és,35040,17251,17789,34631,17085,17546,3471,1802,1669,18984,9883,9101,12581,5562,7019,6439,2456,3983,407,147,557,2,26,16,42,29,52,12
R12236,êÁótåß,çÅéÊés,72356,35626,36730,71011,35069,35942,6637,3440,3197,38325,20003,18322,26659,11857,14802,13477,5292,8185,841,352,1133,6,47,40,96,55,122,19
R12237,êÁótåß,éRïêés,48444,24200,24244,47376,23634,23742,4321,2268,2053,26518,13761,12757,17329,7993,9336,8373,3400,4973,907,197,719,1,27,22,69,33,98,8
R12238,êÁótåß,Ç¢Ç∑Ç›és,35544,17362,18182,35101,17185,17916,3162,1657,1505,17316,8917,8399,15065,6787,8278,8126,3338,4788,443,142,565,2,22,14,42,20,58,11
R12239,êÁótåß,ëÂñ‘îíó¢és,48129,23549,24580,47286,23189,24097,5090,2563,2527,26858,13446,13412,15770,7285,8485,7393,3119,4274,576,229,579,2,32,20,65,24,78,8
R12322,êÁótåß,éÅXà‰í¨,20745,10155,10590,19957,9835,10122,2009,995,1014,11533,5894,5639,6810,3098,3712,3357,1507,1850,445,79,179,1,8,11,15,10,28,3
R12329,êÁótåß,âhí¨,20127,9869,10258,19880,9779,10101,1645,811,834,10633,5380,5253,7840,3672,4168,3092,1327,1765,247,73,249,1,6,7,12,11,25,2
R12342,êÁótåß,ê_çËí¨,5816,2938,2878,5619,2832,2787,506,255,251,3227,1738,1489,2011,912,1099,1068,430,638,125,22,96,0,3,2,1,2,5,2
R12347,êÁótåß,ëΩå√í¨,13735,6941,6794,13261,6675,6586,1242,620,622,7279,3911,3368,5097,2328,2769,2677,1087,1590,401,51,216,1,8,7,17,7,32,1
R12349,êÁótåß,ìåèØí¨,13228,6575,6653,12972,6401,6571,1254,664,590,6748,3557,3191,5187,2328,2859,2558,1042,1516,236,37,223,1,5,5,7,6,7,3
R12403,êÁótåß,ã„è\ã„ó¢í¨,14639,7203,7436,14284,7022,7262,1111,578,533,7499,3911,3588,5920,2645,3275,2912,1122,1790,290,44,266,1,6,5,15,5,22,3
R12409,êÁótåß,é≈éRí¨,7033,3474,3559,6839,3394,3445,605,304,301,3778,1982,1796,2629,1173,1456,1437,559,878,186,23,101,1,3,4,12,9,19,3
R12410,êÁótåß,â°é≈åıí¨,22075,10767,11308,21752,10634,11118,2224,1177,1047,11549,5889,5660,8295,3698,4597,4290,1691,2599,315,104,314,1,11,10,13,17,38,8
R12421,êÁótåß,àÍã{í¨,11897,5824,6073,11644,5707,5937,1443,765,678,6378,3229,3149,3890,1708,2182,2005,792,1213,125,60,193,0,11,8,10,10,14,4
R12422,êÁótåß,ñrëÚí¨,6760,3259,3501,6718,3248,3470,664,342,322,3250,1641,1609,2843,1273,1570,1501,610,891,42,32,111,0,3,2,2,1,7,1
R12423,êÁótåß,í∑ê∂ë∫,13803,6801,7002,13715,6772,6943,1275,659,616,7786,3981,3805,4740,2159,2581,2349,975,1374,88,53,187,0,9,5,4,5,13,3
R12424,êÁótåß,îíéqí¨,10305,5115,5190,10219,5080,5139,944,490,454,5176,2653,2523,4162,1956,2206,2037,877,1160,83,43,195,0,5,4,5,5,9,3
R12426,êÁótåß,í∑ïøí¨,6721,3295,3426,6651,3269,3382,492,260,232,3264,1700,1564,2960,1331,1629,1519,581,938,70,20,111,2,4,1,18,1,17,1
R12427,êÁótåß,í∑ìÏí¨,7198,3527,3671,7172,3521,3651,515,274,241,3468,1796,1672,3215,1457,1758,1654,669,985,26,23,146,0,5,4,2,4,7,1
R12441,êÁótåß,ëÂëΩäÏí¨,8885,4307,4578,8784,4256,4528,771,392,379,4213,2146,2067,3883,1756,2127,2116,827,1289,92,26,192,2,5,3,23,5,14,2
R12443,êÁótåß,å‰èhí¨,6874,3260,3614,6836,3246,3590,465,225,240,2817,1393,1424,3570,1628,1942,1907,812,1095,33,18,154,0,4,4,5,5,3,1
R12463,êÁótåß,ãòìÏí¨,6993,3356,3637,6926,3336,3590,519,279,240,3109,1560,1549,3361,1513,1848,1815,740,1075,63,14,142,1,5,4,9,5,11,1
R13101,ìåãûìs,êÁë„ìcãÊ,66680,33637,33043,63790,32065,31725,8976,4588,4388,46517,24136,22381,10852,4665,6187,5677,2159,3518,2724,658,406,15,506,332,1870,1762,4848,22
R13102,ìåãûìs,íÜâõãÊ,169179,80931,88248,161672,77263,84409,23086,11669,11417,121217,58810,62407,24683,10353,14330,12585,4605,7980,7385,2061,936,4,658,455,1540,600,4708,61
R13103,ìåãûìs,ç`ãÊ,260486,123410,137076,234966,110007,124959,34714,17733,16981,174886,83880,91006,42546,17325,25221,21714,7870,13844,17409,2655,1596,12,814,582,3263,868,4065,75
R13104,ìåãûìs,êVèhãÊ,349385,174822,174563,298415,148196,150219,29202,14761,14441,223593,114521,109072,63185,27132,36053,33311,12480,20831,27216,2402,2705,13,663,426,5033,775,2944,76
R13105,ìåãûìs,ï∂ãûãÊ,240069,115483,124586,217429,103879,113550,28065,14269,13796,152818,74459,78359,42020,17512,24508,21841,8138,13703,8457,2059,1625,10,288,253,4913,964,2139,87
R13106,ìåãûìs,ë‰ìåãÊ,211444,108586,102858,197051,101367,95684,18648,9551,9097,142955,75922,67033,47510,22080,25430,24888,10022,14866,14275,1540,2047,7,251,236,478,329,615,45
R13107,ìåãûìs,ñnìcãÊ,272085,134787,137298,261231,130116,131115,28028,14365,13663,183630,93676,89954,60108,26500,33608,31520,12273,19247,10767,2293,2518,13,231,195,831,255,771,82
R13108,ìåãûìs,ç]ìåãÊ,524310,258015,266295,492456,243169,249287,66472,33996,32476,341716,173311,168405,110002,48178,61824,54659,21642,33017,28682,4075,4096,18,419,306,1461,407,1413,158
R13109,ìåãûìs,ïiêÏãÊ,422488,208688,213800,390799,192236,198563,47036,23838,23198,272685,138081,134604,79532,33927,45605,41045,15563,25482,11897,3803,3137,15,484,347,1637,533,2028,133
R13110,ìåãûìs,ñ⁄çïãÊ,288088,135820,152268,275731,129698,146033,31547,16182,15365,196916,94873,102043,55811,23133,32678,30144,11264,18880,8642,2290,2026,9,326,280,1195,393,885,88
R13111,ìåãûìs,ëÂìcãÊ,748081,372464,375617,700751,348501,352250,77231,39408,37823,475656,243431,232225,161855,70939,90916,84224,32771,51453,20358,5456,6698,26,612,539,1932,1038,1782,177
R13112,ìåãûìs,ê¢ìcíJãÊ,943664,445592,498072,916972,432101,484871,108940,55950,52990,638629,307904,330725,190042,78845,111197,102105,37513,64592,22364,6684,6818,27,901,752,2293,976,2036,203
R13113,ìåãûìs,èaíJãÊ,243883,117907,125976,214511,102183,112328,22984,11651,11333,154258,75693,78565,41261,17025,24236,21900,7981,13919,8704,1945,1533,17,622,426,1573,609,1373,62
R13114,ìåãûìs,íÜñÏãÊ,344880,172525,172355,315718,158474,157244,29123,14850,14273,231515,121148,110367,65878,28075,37803,35029,13222,21807,15391,2435,2783,8,315,248,675,344,803,84
R13115,ìåãûìs,êôï¿ãÊ,591108,284301,306807,551816,263795,288021,58944,30083,28861,380639,186108,194531,117072,49081,67991,62778,23433,39345,14107,4349,4663,20,511,425,1053,586,1260,158
R13116,ìåãûìs,ñLìáãÊ,301599,151020,150579,272053,136359,135694,26489,13465,13024,211034,109537,101497,58539,25291,33248,30361,11250,19111,25573,1842,2434,14,471,312,815,439,1397,88
R13117,ìåãûìs,ñkãÊ,355213,176289,178924,334774,166128,168646,36527,18658,17869,229948,119167,110781,87381,37587,49794,46989,17661,29328,20368,2683,3529,17,285,236,715,322,1102,91
R13118,ìåãûìs,çrêÏãÊ,217475,107683,109792,199289,98955,100334,24470,12428,12042,141156,72237,68919,50411,22315,28096,26272,10193,16079,16814,1620,2025,12,187,130,531,177,507,57
R13119,ìåãûìs,î¬ã¥ãÊ,584483,286179,298304,543391,265687,277704,60014,30821,29193,367976,184716,183260,132602,57258,75344,69519,26354,43165,23049,3862,5190,40,385,343,2558,479,1752,134
R13120,ìåãûìs,ó˚înãÊ,752608,361770,390838,714410,344488,369922,85920,43973,41947,478648,236655,241993,159298,68154,91144,87102,33299,53803,18129,5406,6348,16,569,451,1215,596,1545,176
R13121,ìåãûìs,ë´óßãÊ,695043,347408,347635,644285,322261,322024,75589,38692,36897,424335,219784,204551,170261,74792,95469,92601,36575,56026,29791,4387,7197,52,431,373,980,517,1433,156
R13122,ìåãûìs,äãè¸ãÊ,453093,225758,227335,432623,216134,216489,51556,26487,25069,285968,148207,137761,111893,49424,62469,59706,23284,36422,19229,3132,4651,21,360,274,933,337,1052,121
R13123,ìåãûìs,ç]åÀêÏãÊ,697932,351327,346605,650161,327003,323158,86270,44123,42147,449387,232990,216397,145764,64620,81144,76738,30631,46107,31840,4984,5994,21,431,362,897,544,1260,132
R13201,ìåãûìs,î™â§éqés,579355,291307,288048,554415,278465,275950,62867,32420,30447,344893,179495,165398,153504,68640,84864,79254,33113,46141,11790,2905,5396,31,379,288,1172,403,1608,102
R13202,ìåãûìs,óßêÏés,183581,91191,92390,179304,89196,90108,21828,11219,10609,115971,60115,55856,45524,19759,25765,24008,9454,14554,4221,1205,1808,8,173,123,662,225,568,36
R13203,ìåãûìs,ïêë†ñÏés,150149,71868,78281,143186,68271,74915,17232,8872,8360,95301,46473,48828,31725,13327,18398,16870,6368,10502,2911,1110,1177,8,214,151,545,217,553,34
R13204,ìåãûìs,éOëÈés,195391,94489,100902,185052,89733,95319,23468,12098,11370,123039,61414,61625,41623,17721,23902,22563,8630,13933,3411,1359,1569,7,142,101,1076,145,495,46
R13205,ìåãûìs,ê¬î~és,133535,66654,66881,131357,65672,65685,13763,7073,6690,76704,40231,36473,42492,18985,23507,21938,8920,13018,1858,620,1712,8,88,64,331,86,283,32
R13206,ìåãûìs,ï{íÜés,262790,131468,131322,251627,126350,125277,32986,16961,16025,165586,86141,79445,56764,25099,31665,29560,11806,17754,4893,1784,2171,12,185,153,985,233,1005,56
R13207,ìåãûìs,è∫ìáés,113949,56639,57310,110425,54890,55535,13780,6979,6801,68947,35538,33409,30003,13373,16630,15075,6088,8987,2669,780,1176,8,62,61,205,106,269,23
R13208,ìåãûìs,í≤ïzés,242614,117044,125570,230300,111474,118826,28754,14630,14124,153175,76631,76544,50414,21430,28984,26995,10328,16667,3980,1750,1895,6,198,155,338,217,548,67
R13209,ìåãûìs,í¨ìcés,431079,210533,220546,416777,203111,213666,51174,26206,24968,253130,127768,125362,116470,50596,65874,63712,26045,37667,6276,2407,4078,15,333,232,646,327,1084,76
R13210,ìåãûìs,è¨ã‡à‰és,126074,61759,64315,120520,59144,61376,14879,7653,7226,80498,40707,39791,25591,11065,14526,13179,5033,8146,2456,944,961,4,90,70,162,113,271,33
R13211,ìåãûìs,è¨ïΩés,198739,97507,101232,188185,91890,96295,25072,12968,12104,121648,61306,60342,45060,19436,25624,24296,9497,14799,4673,1379,1722,8,138,96,574,130,465,44
R13212,ìåãûìs,ì˙ñÏés,190435,94918,95517,181908,90814,91094,22894,11730,11164,115015,59846,55169,45652,20035,25617,24684,10199,14485,2989,1352,1596,6,125,91,255,108,400,38
R13213,ìåãûìs,ìåë∫éRés,151815,73827,77988,146966,71307,75659,17720,9135,8585,90285,45286,44999,40749,17524,23225,22109,8704,13405,2723,942,1643,8,97,68,300,107,398,22
R13214,ìåãûìs,çëï™éõés,129242,62985,66257,122391,59838,62553,15082,7796,7286,81431,41002,40429,27184,11696,15488,14600,5744,8856,2257,933,984,2,116,77,131,103,251,36
R13215,ìåãûìs,çëóßés,77130,37515,39615,73679,35750,37929,8448,4452,3996,48511,24068,24443,17748,7570,10178,9261,3512,5749,1565,474,665,2,87,69,113,94,197,20
R13218,ìåãûìs,ïüê∂és,56414,28023,28391,52577,26178,26399,5692,2905,2787,34800,18122,16678,15153,6696,8457,7694,3011,4683,3080,335,613,4,42,32,132,39,163,14
R13219,ìåãûìs,çùç]és,84772,41043,43729,81557,39335,42222,9736,5028,4708,52699,26208,26491,19961,8461,11500,11196,4273,6923,1159,619,763,2,61,39,292,51,184,21
R13220,ìåãûìs,ìåëÂòaés,83901,41034,42867,82703,40561,42142,10661,5381,5280,50007,25368,24639,22923,10157,12766,12295,5056,7239,1071,558,812,2,51,45,137,57,213,16
R13221,ìåãûìs,ê¥ê£és,76208,36550,39658,73650,35232,38418,8710,4425,4285,44106,21880,22226,21482,9124,12358,12186,4727,7459,1230,443,877,9,46,36,243,44,322,15
R13222,ìåãûìs,ìåãvóØïƒés,115271,55647,59624,112209,54284,57925,13735,6997,6738,67397,33960,33437,32745,14126,18619,17955,7195,10760,2028,698,1291,3,67,56,104,66,226,21
R13223,ìåãûìs,ïêë†ë∫éRés,70829,35260,35569,68476,34142,34334,9375,4804,4571,41663,21463,20200,18847,8435,10412,9818,4137,5681,1472,461,675,4,27,25,133,35,164,13
R13224,ìåãûìs,ëΩñÄés,146951,71611,75340,144361,70464,73897,16577,8425,8152,87607,44358,43249,42582,18734,23848,21751,9224,12527,2366,774,1309,6,112,65,461,123,447,23
R13225,ìåãûìs,àÓèÈés,93151,46879,46272,90418,45350,45068,13130,6804,6326,58186,29916,28270,20087,9072,11015,10213,4344,5869,1312,689,645,3,51,43,145,70,210,19
R13227,ìåãûìs,âHë∫és,54326,27471,26855,52873,26754,26119,6531,3376,3155,32849,17369,15480,14728,6569,8159,7679,3183,4496,1313,303,528,2,35,32,44,60,69,13
R13228,ìåãûìs,Ç†Ç´ÇÈñÏés,79292,39230,40062,77709,38510,39199,9235,4718,4517,43149,22082,21067,23792,10799,12993,12838,5534,7304,839,419,958,3,48,36,122,60,126,15
R13229,ìåãûìs,êºìåãûés,207388,100992,106396,197586,95726,101860,24707,12558,12149,128947,64704,64243,48446,20596,27850,26109,9939,16170,4566,1389,1845,5,145,118,290,141,527,39
R13303,ìåãûìs,êêï‰í¨,31765,15992,15773,31026,15591,15435,3443,1761,1682,18609,9789,8820,9517,4330,5187,4641,1948,2693,712,144,389,1,14,11,23,12,27,9
R13305,ìåãûìs,ì˙ÇÃèoí¨,16958,8267,8691,16784,8179,8605,2235,1157,1078,8095,4245,3850,6538,2809,3729,3806,1522,2284,75,82,342,2,14,6,18,4,24,5
R13307,ìåãûìs,ûwå¥ë∫,2003,983,1020,1998,982,1016,131,71,60,806,451,355,1058,455,603,650,226,424,5,7,90,0,3,0,2,1,0,1
R13308,ìåãûìs,âúëΩñÄí¨,4750,2389,2361,4698,2367,2331,337,191,146,1998,1130,868,2410,1066,1344,1428,553,875,48,14,174,1,8,2,9,1,6,2
R13361,ìåãûìs,ëÂìáí¨,7102,3667,3435,7016,3596,3420,710,372,338,3679,2066,1613,2713,1229,1484,1418,563,855,86,38,123,0,3,5,7,4,8,4
R13362,ìåãûìs,óòìáë∫,327,197,130,322,194,128,50,28,22,197,126,71,80,43,37,32,14,18,5,0,5,0,1,0,1,0,0,1
R13363,ìåãûìs,êVìáë∫,2441,1204,1237,2430,1200,1230,272,128,144,1202,647,555,967,429,538,507,201,306,11,16,44,0,3,0,4,1,1,2
R13364,ìåãûìs,ê_í√ìáë∫,1855,952,903,1850,948,902,274,144,130,994,535,459,587,273,314,269,102,167,5,14,25,0,2,0,1,1,1,1
R13381,ìåãûìs,éOëÓë∫,2273,1269,1004,2242,1260,982,225,123,102,1151,703,448,894,441,453,469,189,280,31,18,48,0,2,1,3,1,2,1
R13382,ìåãûìs,å‰ë†ìáë∫,323,181,142,313,172,141,60,36,24,205,114,91,58,31,27,17,9,8,10,2,5,0,1,0,1,0,0,0
R13401,ìåãûìs,î™è‰í¨,7042,3534,3508,6955,3524,3431,799,426,373,3415,1825,1590,2801,1262,1539,1392,545,847,82,41,132,1,2,7,7,6,9,3
R13402,ìåãûìs,ê¬Éñìáë∫,169,102,67,169,102,67,21,12,9,117,69,48,31,21,10,7,4,3,0,1,2,0,1,0,1,0,0,0
R13421,ìåãûìs,è¨ä}å¥ë∫,2929,1805,1124,2905,1792,1113,416,231,185,2099,1327,772,413,246,167,158,83,75,23,31,16,0,3,1,6,4,0,1
R14100,ê_ìﬁêÏåß,â°ïlés,3777491,1867305,1910186,3618590,1787120,1831470,441810,226591,215219,2316309,1179199,1137110,920583,407795,512788,483077,196216,286861,88067,24828,33619,112,3058,2101,9200,3442,10256,862
R14130,ê_ìﬁêÏåß,êÏçËés,1538262,775772,762490,1465906,739466,726440,189490,97260,92230,1001271,519940,481331,301151,134157,166994,153943,61807,92136,38482,12480,11594,33,1023,757,3826,1108,3804,399
R14150,ê_ìﬁêÏåß,ëäñÕå¥és,725493,362193,363300,690937,344898,346039,82532,42298,40234,435860,224715,211145,185236,83633,101603,94619,40355,54264,13334,4563,6671,32,428,363,1746,499,1757,139
R14201,ê_ìﬁêÏåß,â°ê{âÍés,388078,193513,194565,382667,190970,191697,40747,20867,19880,221918,117046,104872,124727,55166,69561,67032,27588,39444,5081,2025,4879,12,306,221,884,531,868,49
R14203,ê_ìﬁêÏåß,ïΩíÀés,258422,129056,129366,249623,124684,124939,29331,14997,14334,151095,78245,72850,72510,32492,40018,36945,15268,21677,4715,1513,2685,7,189,135,510,169,648,42
R14204,ê_ìﬁêÏåß,äôëqés,172710,81097,91613,170631,80086,90545,19587,9975,9612,98856,48270,50586,53378,22482,30896,30674,12074,18600,1401,890,1945,11,178,130,643,167,644,31
R14205,ê_ìﬁêÏåß,ì°ëÚés,436905,215596,221309,425047,209132,215915,56803,29091,27712,265260,135142,130118,106517,46383,60134,56326,22837,33489,5198,3223,3828,14,416,273,987,397,1420,77
R14206,ê_ìﬁêÏåß,è¨ìcå¥és,188856,91321,97535,183545,89142,94403,20684,10672,10012,108355,54551,53804,56588,24748,31840,29397,11627,17770,2312,1047,2322,11,152,109,413,132,604,33
R14207,ê_ìﬁêÏåß,äùÉñçËés,242389,117608,124781,238852,115694,123158,31061,15857,15204,144452,72042,72410,64882,28473,36409,34522,14225,20297,1753,1539,2244,6,162,131,402,169,557,50
R14208,ê_ìﬁêÏåß,êÄéqés,57060,26719,30341,55543,26011,29532,6386,3254,3132,31144,15093,16051,17948,7594,10354,10353,4110,6243,491,302,688,2,73,42,87,63,113,7
R14210,ê_ìﬁêÏåß,éOâYés,42069,20142,21927,41643,19946,21697,3472,1790,1682,21264,10780,10484,17158,7504,9654,9189,3614,5575,294,132,709,1,27,22,61,32,85,4
R14211,ê_ìﬁêÏåß,ê`ñÏés,162439,82134,80305,156966,79142,77824,17797,9242,8555,93225,48891,44334,48518,22187,26331,23214,9991,13223,3254,822,1573,5,100,81,213,120,310,31
R14212,ê_ìﬁêÏåß,å˙ñÿés,223705,115343,108362,213520,110131,103389,26156,13421,12735,136825,73877,62948,57522,26468,31054,27605,12082,15523,7283,1321,2013,9,154,104,437,142,524,36
R14213,ê_ìﬁêÏåß,ëÂòaés,239169,119582,119587,226223,112710,113513,28937,14656,14281,146702,75667,71035,56696,25248,31448,29390,12233,17157,6189,1716,1970,8,178,142,401,202,636,52
R14214,ê_ìﬁêÏåß,à…ê®å¥és,101780,51486,50294,97675,49517,48158,11659,5917,5742,61640,32564,29076,26579,12106,14473,13563,5810,7753,2509,680,895,3,66,52,722,85,329,17
R14215,ê_ìﬁêÏåß,äCòVñºés,136516,68631,67885,132164,66290,65874,17660,9121,8539,82979,42904,40075,33825,15416,18409,16863,7325,9538,2431,1012,1061,4,96,55,258,82,329,25
R14216,ê_ìﬁêÏåß,ç¿ä‘és,132325,66001,66324,126292,63234,63058,14957,7602,7355,80388,41761,38627,33638,15177,18461,16963,7135,9828,2935,801,1162,4,57,63,126,55,245,25
R14217,ê_ìﬁêÏåß,ìÏë´ïøés,40841,20000,20841,40292,19729,20563,4492,2292,2200,22509,11516,10993,13440,5991,7449,7073,2984,4089,335,155,523,2,24,16,42,19,82,6
R14218,ê_ìﬁêÏåß,àªê£és,83913,42581,41332,79277,40101,39176,10852,5568,5284,48874,26033,22841,23186,10565,12621,12053,5368,6685,3771,467,772,1,34,27,49,33,88,11
R14301,ê_ìﬁêÏåß,ótéRí¨,31665,14914,16751,31126,14607,16519,3955,2043,1912,17156,8284,8872,10071,4307,5764,5672,2341,3331,234,139,357,1,17,17,36,22,42,5
R14321,ê_ìﬁêÏåß,ä¶êÏí¨,48348,24466,23882,47069,23788,23281,6165,3191,2974,28431,14863,13568,13250,6083,7167,6482,2841,3641,857,311,460,1,22,18,48,25,78,5
R14341,ê_ìﬁêÏåß,ëÂàÈí¨,31634,15411,16223,31484,15338,16146,3569,1846,1723,17192,8680,8512,10853,4870,5983,5650,2406,3244,141,154,376,1,18,17,74,16,76,4
R14342,ê_ìﬁêÏåß,ìÒã{í¨,27564,13285,14279,27278,13165,14113,2828,1471,1357,14887,7412,7475,9682,4331,5351,5321,2277,3044,174,124,352,0,22,19,23,20,51,5
R14361,ê_ìﬁêÏåß,íÜà‰í¨,9300,4664,4636,8967,4488,4479,839,403,436,4836,2559,2277,3303,1499,1804,1630,698,932,329,26,103,1,8,4,8,4,30,2
R14362,ê_ìﬁêÏåß,ëÂà‰í¨,17129,8437,8692,16897,8332,8565,2019,1011,1008,10031,5166,4865,4963,2214,2749,2496,1042,1454,120,92,174,1,9,7,14,13,37,2
R14363,ê_ìﬁêÏåß,èºìcí¨,10836,5404,5432,10661,5320,5341,1030,543,487,6030,3173,2857,3651,1609,2042,1903,757,1146,80,52,141,1,9,5,62,6,43,1
R14364,ê_ìﬁêÏåß,éRñkí¨,9761,4826,4935,9688,4789,4899,821,411,410,5039,2654,2385,3873,1745,2128,1918,782,1136,73,24,163,0,6,3,6,3,5,2
R14366,ê_ìﬁêÏåß,äJê¨í¨,18329,8911,9418,18150,8832,9318,2709,1374,1335,10804,5430,5374,4768,2086,2682,2596,1070,1526,156,141,156,1,20,10,21,13,82,3
R14382,ê_ìﬁêÏåß,î†ç™í¨,11293,5423,5870,10768,5191,5577,683,340,343,5940,2995,2945,4120,1773,2347,2170,833,1337,354,24,180,1,8,6,5,5,14,3
R14383,ê_ìﬁêÏåß,ê^íﬂí¨,6722,3124,3598,6659,3099,3560,446,214,232,3344,1651,1693,2923,1255,1668,1574,606,968,56,18,111,0,3,2,3,2,6,2
R14384,ê_ìﬁêÏåß,ìíâÕå¥í¨,23426,10884,12542,23045,10739,12306,1749,929,820,11477,5759,5718,9961,4096,5865,5534,2073,3461,273,68,402,3,21,15,40,15,51,4
R14401,ê_ìﬁêÏåß,à§êÏí¨,39869,20883,18986,36633,19117,17516,4231,2189,2042,23225,12718,10507,11947,5679,6268,5418,2406,3012,2831,165,438,1,21,11,22,13,53,6
R14402,ê_ìﬁêÏåß,ê¥êÏë∫,3038,1556,1482,3016,1548,1468,306,143,163,1600,881,719,1131,531,600,500,218,282,22,11,35,0,2,1,8,1,5,1
R15100,êVäÉåß,êVäÉés,789275,379741,409534,772337,371024,401313,91023,46594,44429,450987,225131,225856,230990,98975,132015,117387,45017,72370,4672,5154,8974,37,645,490,2408,1181,2013,244
R15202,êVäÉåß,í∑â™és,266936,131011,135925,264201,129993,134208,31270,16036,15234,149389,76696,72693,83371,36371,47000,43143,16860,26283,2091,1618,3468,9,175,120,622,169,542,84
R15204,êVäÉåß,éOèés,94642,45815,48827,93563,45265,48298,10607,5410,5197,51991,26450,25541,31258,13604,17654,16261,6299,9962,596,535,1311,6,68,48,148,75,185,28
R15205,êVäÉåß,îêçËés,81526,40556,40970,79760,39637,40123,8633,4443,4190,44253,23311,20942,27398,11955,15443,14206,5418,8788,779,412,1230,4,58,37,124,54,121,28
R15206,êVäÉåß,êVî≠ìcés,94927,45963,48964,93973,45581,48392,11067,5710,5357,52607,26905,25702,30646,13027,17619,15614,5736,9878,574,588,1283,5,79,50,233,77,195,34
R15208,êVäÉåß,è¨êÁíJés,34096,16830,17266,33810,16745,17065,3823,1915,1908,17981,9389,8592,12092,5419,6673,6361,2573,3788,172,177,495,2,24,15,48,17,43,12
R15209,êVäÉåß,â¡ñŒés,25441,12406,13035,25324,12354,12970,2407,1229,1178,13607,7037,6570,9356,4087,5269,4813,1893,2920,89,113,418,1,20,12,34,17,62,11
R15210,êVäÉåß,è\ì˙í¨és,49820,24339,25481,49464,24263,25201,5255,2709,2546,24595,12827,11768,19838,8725,11113,10825,4278,6547,276,243,780,2,35,19,58,28,71,18
R15211,êVäÉåß,å©ïçés,39237,19050,20187,38908,18941,19967,4495,2320,2175,21682,10991,10691,12939,5661,7278,6795,2661,4134,230,236,521,1,28,21,29,24,62,11
R15212,êVäÉåß,ë∫è„és,57418,27474,29944,57104,27380,29724,5520,2789,2731,29209,15132,14077,22619,9501,13118,12301,4530,7771,312,297,973,6,41,29,84,39,102,15
R15213,êVäÉåß,âçés,77201,37629,39572,76352,37204,39148,8863,4513,4350,43797,22394,21403,24060,10424,13636,12451,4911,7540,456,467,942,2,72,39,104,55,138,24
R15216,êVäÉåß,éÖãõêÏés,40765,20068,20697,40242,19841,20401,4005,2095,1910,20213,10770,9443,16296,7045,9251,9144,3581,5563,361,174,689,2,34,17,64,23,66,17
R15217,êVäÉåß,ñ≠çÇés,30383,14740,15643,30075,14643,15432,3139,1636,1503,15826,8153,7673,11319,4883,6436,6139,2268,3871,264,151,551,2,13,12,19,13,42,11
R15218,êVäÉåß,å‹êÚés,47625,22890,24735,47129,22783,24346,4857,2512,2345,25570,12989,12581,17143,7352,9791,8801,3300,5501,472,213,722,2,38,22,51,29,87,17
R15222,êVäÉåß,è„âzés,188047,91929,96118,185027,90696,94331,22044,11322,10722,102314,52708,49606,61460,26748,34712,32056,12239,19817,1507,1100,2519,7,140,91,394,130,393,59
R15223,êVäÉåß,à¢âÍñÏés,40696,19570,21126,40371,19449,20922,4501,2320,2181,22065,11180,10885,14011,5996,8015,7024,2521,4503,240,218,587,2,25,17,40,24,50,14
R15224,êVäÉåß,ç≤ìnés,51492,24881,26611,51208,24797,26411,5143,2709,2434,24279,12668,11611,21927,9415,12512,12636,4696,7940,200,248,1124,4,40,19,93,30,88,24
R15225,êVäÉåß,ãõè¿és,34483,16802,17681,34209,16691,17518,3610,1823,1787,17816,9163,8653,12899,5722,7177,6817,2631,4186,220,199,475,1,25,12,36,15,48,10
R15226,êVäÉåß,ìÏãõè¿és,54851,26777,28074,53962,26479,27483,6561,3342,3219,29347,14865,14482,18391,8233,10158,9246,3602,5644,689,323,767,4,25,17,127,26,109,27
R15227,êVäÉåß,ëŸì‡és,28509,13959,14550,28219,13802,14417,2968,1533,1435,15165,7884,7281,10262,4474,5788,5326,2027,3299,190,132,428,1,23,13,26,17,33,10
R15307,êVäÉåß,êπ‚ƒí¨,14259,7172,7087,13930,7018,6912,2073,1088,985,8390,4499,3891,3716,1531,2185,1840,619,1221,277,130,160,2,5,6,21,7,16,4
R15342,êVäÉåß,ñÌïFë∫,7705,3733,3972,7685,3727,3958,925,466,459,4305,2179,2126,2471,1084,1387,1171,437,734,20,35,92,0,5,2,2,2,2,3
R15361,êVäÉåß,ìcè„í¨,11227,5395,5832,11183,5375,5808,1019,530,489,5960,3043,2917,4228,1808,2420,2117,778,1339,39,39,144,0,5,5,4,5,10,1
R15385,êVäÉåß,à¢âÍí¨,9965,4825,5140,9929,4818,5111,673,365,308,4346,2330,2016,4944,2128,2816,2993,1077,1916,36,30,248,1,8,8,11,8,11,3
R15405,êVäÉåß,èoâ_çËí¨,4113,1978,2135,4099,1974,2125,372,171,201,1936,1029,907,1803,776,1027,1029,376,653,14,17,89,0,4,1,2,1,3,2
R15461,êVäÉåß,ìíëÚí¨,7767,3946,3821,7640,3894,3746,678,333,345,4012,2143,1869,2958,1389,1569,1511,610,901,111,40,109,1,3,4,11,5,9,1
R15482,êVäÉåß,í√ìÏí¨,8989,4322,4667,8886,4311,4575,882,455,427,4273,2217,2056,3767,1635,2132,2243,846,1397,103,39,194,1,8,3,6,3,10,5
R15504,êVäÉåß,ä†âHë∫,4380,2244,2136,4353,2228,2125,558,283,275,2379,1281,1098,1408,649,759,665,268,397,14,29,51,0,1,1,1,1,0,1
R15581,êVäÉåß,ä÷êÏë∫,5144,2444,2700,5122,2439,2683,467,234,233,2458,1291,1167,2219,919,1300,1285,447,838,22,21,103,0,5,2,3,1,3,2
R15586,êVäÉåß,àæìáâYë∫,353,181,172,351,181,170,42,17,25,165,97,68,146,67,79,87,32,55,2,3,8,0,1,0,0,0,0,1
R16201,ïxéRåß,ïxéRés,413938,202281,211657,403780,197226,206554,48134,24651,23483,235817,120942,114875,122767,52314,70453,63995,24497,39498,6380,2786,4721,39,340,187,1481,281,1458,101
R16202,ïxéRåß,çÇâ™és,166393,80482,85911,159520,77095,82425,16902,8745,8157,86993,44125,42868,54956,23278,31678,28782,10986,17796,2986,987,2123,12,136,85,471,122,444,48
R16204,ïxéRåß,ãõí√és,40535,19729,20806,39869,19453,20416,3923,1982,1941,21193,11115,10078,13906,5829,8077,7497,2827,4670,384,255,565,4,31,21,89,29,65,14
R16205,ïxéRåß,ïXå©és,43950,20883,23067,43525,20717,22808,4022,2055,1967,22499,11504,10995,17391,7309,10082,9139,3353,5786,424,183,700,3,31,14,79,18,66,13
R16206,ïxéRåß,ääêÏés,32349,15750,16599,31902,15533,16369,4047,2128,1919,18432,9489,8943,9744,4048,5696,5042,1848,3194,387,200,367,2,20,9,50,15,103,14
R16207,ïxéRåß,çïïîés,39638,19514,20124,39171,19293,19878,4645,2434,2211,21761,11343,10418,12517,5311,7206,6602,2499,4103,315,246,484,4,25,17,136,25,91,14
R16208,ïxéRåß,ìvîgés,48154,23419,24735,47060,22869,24191,5911,3015,2896,27087,13793,13294,14593,6270,8323,7501,2802,4699,709,280,516,5,35,19,145,35,93,14
R16209,ïxéRåß,è¨ñÓïîés,28983,13991,14992,28413,13756,14657,2940,1514,1426,15086,7667,7419,10817,4724,6093,5705,2187,3518,514,162,407,4,16,11,55,17,49,8
R16210,ïxéRåß,ìÏìvés,47937,22940,24997,47104,22630,24474,4979,2561,2418,24165,12266,11899,18753,8089,10664,10097,3810,6287,811,236,760,4,32,16,92,21,100,15
R16211,ïxéRåß,éÀêÖés,90742,44253,46489,88002,42779,45223,11269,5869,5400,51219,26166,25053,27743,11867,15876,13843,5368,8475,2374,540,1100,4,49,34,126,50,209,25
R16321,ïxéRåß,èMã¥ë∫,3132,1521,1611,3081,1494,1587,528,277,251,1971,985,986,631,257,374,371,131,240,51,25,31,0,1,2,0,2,1,1
R16322,ïxéRåß,è„ésí¨,19351,9255,10096,19133,9160,9973,1852,959,893,10280,5223,5057,7199,3058,4141,3785,1458,2327,217,60,280,1,11,6,41,8,89,10
R16323,ïxéRåß,óßéRí¨,24792,12002,12790,24573,11911,12662,2780,1429,1351,13698,6977,6721,8273,3571,4702,4284,1645,2639,207,151,348,1,14,8,17,9,35,7
R16342,ïxéRåß,ì¸ëPí¨,23839,11385,12454,23305,11144,12161,2342,1206,1136,12621,6458,6163,8780,3673,5107,4676,1731,2945,443,108,375,2,15,7,24,11,25,7
R16343,ïxéRåß,í©ì˙í¨,11081,5232,5849,10950,5185,5765,903,470,433,5230,2690,2540,4938,2065,2873,2807,1057,1750,124,37,204,2,3,6,26,7,27,3
R17201,êŒêÏåß,ã‡ëÚés,463254,224549,238705,446412,215482,230930,56073,28609,27464,271778,136161,135617,121222,51449,69773,61301,23334,37967,4798,3400,4492,37,412,225,1928,374,1533,121
R17202,êŒêÏåß,éµîˆés,50300,23970,26330,49257,23522,25735,4997,2593,2404,25395,12682,12713,19370,8321,11049,9968,3778,6190,643,239,792,5,39,29,185,37,116,21
R17203,êŒêÏåß,è¨èºés,106216,52182,54034,102830,50152,52678,13834,7080,6754,60584,31068,29516,30443,13162,17281,15912,6322,9590,2271,829,1143,9,72,45,218,70,225,34
R17204,êŒêÏåß,ó÷ìáés,24608,11714,12894,24360,11597,12763,1807,928,879,11351,6007,5344,11327,4696,6631,6335,2288,4047,173,87,494,1,26,12,38,18,42,12
R17205,êŒêÏåß,éÏèFés,12929,5933,6996,12838,5903,6935,926,446,480,5309,2697,2612,6673,2778,3895,3733,1325,2408,75,42,260,1,10,5,24,5,16,7
R17206,êŒêÏåß,â¡âÍés,63220,29939,33281,62143,29453,32690,6715,3472,3243,33589,16915,16674,22681,9422,13259,11791,4392,7399,915,322,921,3,46,26,134,38,104,27
R17207,êŒêÏåß,âHçÓés,20407,9669,10738,20262,9621,10641,1928,967,961,10189,5150,5039,8231,3507,4724,4395,1644,2751,145,100,352,1,19,15,39,19,37,10
R17209,êŒêÏåß,Ç©ÇŸÇ≠és,34889,16875,18014,34500,16640,17860,4696,2427,2269,19657,9830,9827,10314,4502,5812,5273,2076,3197,297,272,389,2,21,8,47,17,50,11
R17210,êŒêÏåß,îíéRés,110408,53670,56738,108485,52493,55992,15154,7596,7558,63630,31948,31682,30899,13742,17157,14563,5880,8683,1402,769,1083,4,66,31,163,44,241,30
R17211,êŒêÏåß,î\î¸és,48523,24129,24394,47278,23328,23950,6811,3510,3301,28783,14897,13886,12692,5555,7137,6404,2568,3836,1134,345,462,3,29,11,78,16,82,15
R17212,êŒêÏåß,ñÏÅXésés,57238,29550,27688,55606,28658,26948,8322,4279,4043,35979,19327,16652,11203,4837,6366,5332,2041,3291,473,582,370,2,49,26,77,30,116,16
R17324,êŒêÏåß,êÏñkí¨,6135,3030,3105,6072,2986,3086,1057,566,491,3630,1818,1812,1448,646,802,734,286,448,63,46,59,0,3,3,2,3,6,3
R17361,êŒêÏåß,í√î¶í¨,36957,18044,18913,36527,17789,18738,5057,2627,2430,22675,11315,11360,9040,3977,5063,4349,1704,2645,275,240,359,2,22,10,32,11,46,10
R17365,êŒêÏåß,ì‡ìÂí¨,26574,12774,13800,25988,12461,13527,3305,1714,1591,15554,7619,7935,7081,3107,3974,3465,1405,2060,320,144,244,2,14,9,448,24,120,8
R17384,êŒêÏåß,éuâÍí¨,18630,8878,9752,18467,8836,9631,1656,814,842,8605,4450,4155,8312,3571,4741,4327,1619,2708,163,64,321,2,10,7,18,7,14,5
R17386,êŒêÏåß,ïÛíBéuêÖí¨,12121,5718,6403,11944,5664,6280,1081,537,544,6236,3122,3114,4795,2053,2742,2453,922,1531,173,41,191,1,4,3,8,5,21,4
R17407,êŒêÏåß,íÜî\ìoí¨,16540,7977,8563,16361,7925,8436,1968,1030,938,8418,4276,4142,6147,2665,3482,3208,1244,1964,179,95,271,0,6,6,5,9,10,6
R17461,êŒêÏåß,åäêÖí¨,7890,3793,4097,7781,3732,4049,555,311,244,3400,1827,1573,3872,1607,2265,2172,751,1421,80,30,179,1,11,4,19,4,21,4
R17463,êŒêÏåß,î\ìoí¨,15687,7377,8310,15581,7302,8279,1154,598,556,6621,3459,3162,7910,3318,4592,4403,1573,2830,106,65,339,2,10,6,23,8,29,6
R18201,ïüà‰åß,ïüà‰és,262328,127867,134461,255176,124372,130804,33046,17092,15954,148658,75252,73406,75805,32656,43149,39768,15591,24177,3879,1908,2946,23,260,138,997,216,680,90
R18202,ïüà‰åß,ì÷âÍés,64264,31785,32479,62655,31094,31561,8110,4160,3950,36222,18717,17505,18473,8056,10417,9260,3558,5702,734,452,763,3,49,23,137,33,129,21
R18204,ïüà‰åß,è¨ïlés,28991,14317,14674,27905,13830,14075,3479,1799,1680,15326,8067,7259,9278,3964,5314,5009,1834,3175,278,224,371,2,17,9,70,17,56,13
R18205,ïüà‰åß,ëÂñÏés,31286,14997,16289,30786,14838,15948,3346,1688,1658,16078,8148,7930,11680,5033,6647,6206,2302,3904,469,190,457,4,21,10,26,15,29,13
R18206,ïüà‰åß,èüéRés,22150,10581,11569,21856,10506,11350,2468,1272,1196,11304,5624,5680,8275,3591,4684,4339,1612,2727,277,121,341,1,12,8,42,12,46,11
R18207,ïüà‰åß,éIç]és,68302,33323,34979,67087,32737,34350,9599,4894,4705,39408,19913,19495,18757,8187,10570,9552,3855,5697,787,538,743,6,40,23,113,37,101,22
R18208,ïüà‰åß,Ç†ÇÌÇÁés,27524,13067,14457,26977,12827,14150,2984,1509,1475,14873,7425,7448,9349,3959,5390,4725,1730,2995,466,159,381,3,16,8,41,15,50,12
R18209,ïüà‰åß,âzëOés,80611,39657,40954,75526,37034,38492,10151,5288,4863,45994,23525,22469,23740,10381,13359,12380,4895,7485,4649,567,951,6,46,31,98,41,119,24
R18210,ïüà‰åß,ç‚à‰és,88481,42719,45762,86348,41736,44612,11535,5878,5657,50701,25321,25380,25434,11135,14299,12916,5097,7819,1409,568,971,4,47,25,75,33,128,33
R18322,ïüà‰åß,âiïΩéõí¨,18965,9231,9734,18546,9033,9513,2127,1064,1063,10848,5485,5363,5640,2471,3169,3014,1145,1869,236,104,241,1,11,7,404,19,92,8
R18382,ïüà‰åß,írìcí¨,2423,1196,1227,2409,1183,1226,195,103,92,1150,620,530,1078,473,605,660,253,407,14,17,55,0,3,1,3,1,0,1
R18404,ïüà‰åß,ìÏâzëOí¨,10002,4804,5198,9945,4781,5164,1163,626,537,5072,2582,2490,3767,1596,2171,2087,748,1339,57,58,164,0,8,2,9,3,2,4
R18423,ïüà‰åß,âzëOí¨,20118,9725,10393,19943,9616,10327,2327,1175,1152,10595,5397,5198,7177,3138,4039,3709,1376,2333,174,102,317,2,9,5,16,6,18,12
R18442,ïüà‰åß,î¸ïlí¨,9179,4610,4569,9062,4567,4495,997,536,461,4816,2630,2186,3294,1400,1894,1720,635,1085,70,64,142,0,10,3,6,3,3,3
R18481,ïüà‰åß,çÇïlí¨,10326,5424,4902,10119,5344,4775,1201,620,581,5571,3111,2460,3285,1449,1836,1740,671,1069,144,73,128,1,7,2,12,3,17,4
R18483,ïüà‰åß,Ç®Ç®Ç¢í¨,7910,3968,3942,7834,3957,3877,1088,536,552,4241,2316,1925,2548,1088,1460,1369,498,871,68,71,80,0,7,3,6,5,4,4
R18501,ïüà‰åß,é·ã∑í¨,14003,6702,7301,13894,6640,7254,1728,861,867,7127,3621,3506,5104,2191,2913,2872,1083,1789,85,97,235,1,10,3,19,6,15,9
R19201,éRóúåß,çbï{és,189591,92850,96741,180962,88457,92505,21391,10917,10474,108390,55747,52643,54487,22908,31579,30262,11514,18748,4743,1267,2324,11,221,132,698,205,631,46
R19202,éRóúåß,ïxémãgìcés,46530,22645,23885,44903,21869,23034,5088,2576,2512,26184,13169,13015,14006,6201,7805,7384,2941,4443,437,310,561,1,50,32,101,38,108,8
R19204,éRóúåß,ìsóØés,31016,14949,16067,30122,14542,15580,3133,1607,1526,18015,8917,9098,8772,3913,4859,4538,1846,2692,517,183,355,2,17,13,43,14,51,11
R19205,éRóúåß,éRóúés,33435,16081,17354,33005,15877,17128,3754,1932,1822,18013,8962,9051,11396,5015,6381,6102,2424,3678,185,187,491,3,24,15,127,25,99,10
R19206,éRóúåß,ëÂåéés,22512,10924,11588,22208,10779,11429,1657,801,856,11464,5837,5627,9093,4121,4972,4780,1938,2842,170,76,396,1,21,13,27,20,27,5
R19207,éRóúåß,îBçËés,29067,14500,14567,28547,14264,14283,3164,1654,1510,16909,8806,8103,8906,3982,4924,4432,1822,2610,487,152,333,4,28,14,69,19,98,5
R19208,éRóúåß,ìÏÉAÉãÉvÉXés,69459,34164,35295,68331,33656,34675,9188,4765,4423,40547,20514,20033,19302,8646,10656,9461,3858,5603,971,489,741,4,34,29,74,29,93,21
R19209,éRóúåß,ñkìmés,44053,21492,22561,43545,21289,22256,4257,2195,2062,22112,11273,10839,17619,7973,9646,9074,3716,5358,506,208,670,2,20,21,35,23,54,14
R19210,éRóúåß,çbî„és,75313,37238,38075,73488,36302,37186,9721,4932,4789,42576,21598,20978,19088,8428,10660,9236,3766,5470,965,670,611,4,66,30,79,36,122,19
R19211,éRóúåß,ìJêÅés,66947,32447,34500,65266,31707,33559,7915,4029,3886,37628,18890,18738,19870,8698,11172,10372,4176,6196,874,460,806,8,38,30,109,40,125,25
R19212,éRóúåß,è„ñÏå¥és,22669,11331,11338,22315,11117,11198,1834,936,898,12395,6472,5923,8254,3805,4449,4287,1744,2543,319,81,324,1,16,11,33,14,31,3
R19213,éRóúåß,çbèBés,29237,14068,15169,29045,13998,15047,3032,1554,1478,15440,7737,7703,10717,4743,5974,5791,2317,3474,162,125,420,2,23,14,35,20,59,12
R19214,éRóúåß,íÜâõés,31216,15509,15707,28809,14351,14458,3512,1761,1751,17372,8825,8547,7548,3416,4132,3497,1446,2051,1646,188,269,1,23,14,496,30,136,9
R19346,éRóúåß,ésêÏéOãΩí¨,14700,7164,7536,14467,7050,7417,1418,751,667,7372,3802,3570,5525,2400,3125,3126,1206,1920,213,78,246,1,9,6,15,7,17,7
R19364,éRóúåß,ëÅêÏí¨,1098,627,471,1091,624,467,72,43,29,573,393,180,451,190,261,287,100,187,7,2,23,0,7,0,0,0,1,1
R19365,éRóúåß,êgâÑí¨,10663,5226,5437,10562,5164,5398,665,339,326,4898,2631,2267,5065,2224,2841,2998,1133,1865,96,31,255,3,10,6,15,6,22,6
R19366,éRóúåß,ìÏïîí¨,7156,3496,3660,7097,3457,3640,568,295,273,3464,1829,1635,3124,1372,1752,1645,613,1032,59,23,157,0,9,3,5,2,3,2
R19368,éRóúåß,ïxémêÏí¨,14219,6848,7371,13948,6742,7206,1530,770,760,7635,3937,3698,4929,2082,2847,2739,1016,1723,144,85,237,2,11,8,24,11,28,5
R19384,éRóúåß,è∫òaí¨,20909,10451,10458,19697,9934,9763,3283,1651,1632,13097,6806,6291,3984,1747,2237,1986,822,1164,692,194,116,1,32,16,30,16,75,8
R19422,éRóúåß,ìπéuë∫,1607,811,796,1598,806,792,146,77,69,847,447,400,614,287,327,296,123,173,9,6,24,0,1,1,2,1,0,1
R19423,éRóúåß,êºåjí¨,4041,1947,2094,4012,1934,2078,443,212,231,2367,1177,1190,1231,558,673,620,245,375,29,26,47,0,2,2,3,2,4,1
R19424,éRóúåß,îEñÏë∫,9237,5137,4100,8980,5010,3970,1377,712,665,6032,3612,2420,1809,806,1003,806,303,503,238,96,65,0,6,3,2,5,3,3
R19425,éRóúåß,éRíÜåŒë∫,5179,2559,2620,5055,2487,2568,606,316,290,2822,1432,1390,1731,801,930,823,350,473,121,32,54,0,2,1,12,1,5,2
R19429,éRóúåß,ñ¬ëÚë∫,2824,1390,1434,2802,1380,1422,329,172,157,1498,755,743,957,443,514,467,192,275,21,13,38,0,2,1,1,1,2,1
R19430,éRóúåß,ïxémâÕå˚åŒí¨,26082,12839,13243,25613,12634,12979,3439,1728,1711,15422,7855,7567,6860,3033,3827,3439,1358,2081,373,198,216,1,22,16,64,26,58,8
R19442,éRóúåß,è¨êõë∫,684,344,340,676,339,337,68,35,33,306,162,144,310,147,163,165,66,99,8,3,10,0,1,0,1,0,0,0
R19443,éRóúåß,íOîgéRë∫,530,272,258,529,272,257,39,20,19,255,142,113,236,110,126,138,57,81,1,1,7,0,2,1,1,1,0,0
R20201,í∑ñÏåß,í∑ñÏés,372760,181284,191476,361952,176290,185662,42777,21735,21042,201890,101348,100542,108243,46914,61329,58572,23286,35286,3094,2480,4208,23,284,205,1004,302,895,84
R20202,í∑ñÏåß,èºñ{és,241145,118271,122874,234020,115245,118775,30107,15507,14600,139128,71247,67881,66647,28806,37841,36797,14517,22280,3425,1608,2599,13,231,140,1302,240,814,52
R20203,í∑ñÏåß,è„ìcés,154055,75365,78690,149325,73037,76288,18338,9361,8977,86410,44014,42396,47130,20702,26428,25573,10292,15281,3148,973,1911,11,101,74,291,125,396,41
R20204,í∑ñÏåß,â™íJés,47790,23213,24577,47015,22885,24130,5452,2767,2685,25609,13216,12393,16522,7109,9413,9523,3828,5695,723,279,580,3,28,28,97,45,97,15
R20205,í∑ñÏåß,î—ìcés,98164,47280,50884,95551,46162,49389,12373,6388,5985,52701,26314,26387,31987,13914,18073,17888,7117,10771,1995,654,1319,6,87,59,264,83,217,39
R20206,í∑ñÏåß,êzñKés,48729,23809,24920,47199,23123,24076,5926,3052,2874,27232,14026,13206,15034,6480,8554,8447,3379,5068,1075,331,580,2,47,30,184,42,140,15
R20207,í∑ñÏåß,ê{ç‚és,49559,24324,25235,48692,23950,24742,6025,3077,2948,27198,13973,13225,16017,7090,8927,8505,3504,5001,624,281,583,2,41,23,92,28,91,16
R20208,í∑ñÏåß,è¨èîés,40991,19972,21019,40172,19708,20464,4731,2418,2313,22257,11321,10936,13773,6077,7696,7268,2895,4373,753,265,526,3,32,18,98,26,91,10
R20209,í∑ñÏåß,à…ìﬂés,66125,32437,33688,64391,31680,32711,8183,4160,4023,36480,18705,17775,20663,9151,11512,11398,4635,6763,1645,411,846,3,55,35,170,55,156,22
R20210,í∑ñÏåß,ãÓÉñç™és,32202,15729,16473,31351,15372,15979,3953,2036,1917,17956,9163,8793,9921,4354,5567,5491,2221,3270,552,196,396,2,31,14,79,20,84,10
R20211,í∑ñÏåß,íÜñÏés,42338,20552,21786,41448,20237,21211,5086,2642,2444,23236,11609,11627,13670,6104,7566,7079,2833,4246,546,262,543,2,29,21,115,29,104,13
R20212,í∑ñÏåß,ëÂí¨és,26029,12594,13435,25470,12427,13043,2460,1331,1129,13174,6653,6521,9891,4315,5576,5456,2137,3319,468,141,357,1,27,11,59,16,45,8
R20213,í∑ñÏåß,î—éRés,19539,9498,10041,19326,9415,9911,2003,1031,972,10049,5120,4929,7445,3320,4125,3975,1544,2431,191,95,297,1,13,6,36,11,38,9
R20214,í∑ñÏåß,äùñÏés,56400,28241,28159,54927,27526,27401,7050,3635,3415,31411,16426,14985,17059,7682,9377,9061,3776,5285,907,356,642,1,36,21,135,33,103,18
R20215,í∑ñÏåß,âñêKés,67241,33620,33621,65443,32711,32732,8360,4317,4043,39154,20410,18744,19155,8554,10601,10325,4256,6069,1233,507,752,5,39,30,83,206,112,17
R20217,í∑ñÏåß,ç≤ãvés,98199,48035,50164,95778,46864,48914,12480,6399,6081,54115,27466,26649,30170,13336,16834,16364,6517,9847,1109,729,1215,7,85,55,386,86,256,25
R20218,í∑ñÏåß,êÁã»és,58852,28404,30448,57849,28019,29830,6880,3530,3350,32027,16162,15865,19628,8562,11066,10887,4318,6569,754,343,783,3,40,21,67,30,87,17
R20219,í∑ñÏåß,ìåå‰és,30122,14776,15346,29657,14576,15081,3652,1832,1820,17120,8665,8455,9333,4269,5064,4700,1990,2710,465,192,366,1,12,10,31,14,47,6
R20220,í∑ñÏåß,à¿ì‹ñÏés,94222,45398,48824,92609,44780,47829,11364,5796,5568,52221,26051,26170,29932,13212,16720,15780,6483,9297,1092,565,1076,3,85,42,253,55,261,20
R20303,í∑ñÏåß,è¨äCí¨,4353,2140,2213,4284,2088,2196,404,218,186,2095,1087,1008,1831,821,1010,1065,428,637,68,28,77,1,2,3,14,5,16,1
R20304,í∑ñÏåß,êÏè„ë∫,4344,2591,1753,3519,1815,1704,449,228,221,2697,1778,919,1196,583,613,652,290,362,825,36,49,0,2,1,2,1,3,1
R20305,í∑ñÏåß,ìÏñqë∫,3242,1807,1435,2788,1382,1406,338,165,173,1894,1178,716,996,455,541,547,207,340,452,22,61,0,4,1,2,1,4,2
R20306,í∑ñÏåß,ìÏëäñÿë∫,962,473,489,941,463,478,95,53,42,474,249,225,392,170,222,239,87,152,21,3,20,0,1,0,0,0,0,1
R20307,í∑ñÏåß,ñkëäñÿë∫,752,378,374,718,347,371,104,57,47,378,203,175,270,118,152,182,65,117,34,1,14,0,1,0,0,0,0,1
R20309,í∑ñÏåß,ç≤ãvï‰í¨,10218,4966,5252,10139,4938,5201,1055,545,510,5188,2627,2561,3958,1782,2176,2151,838,1313,70,41,170,1,7,4,11,5,12,3
R20321,í∑ñÏåß,åyà‰ëÚí¨,19188,9178,10010,18660,8890,9770,2133,1032,1101,9991,4822,5169,6148,2788,3360,2989,1228,1761,393,116,209,1,19,10,33,15,29,4
R20323,í∑ñÏåß,å‰ë„ìcí¨,15555,7703,7852,14943,7445,7498,1914,970,944,9036,4584,4452,4323,1982,2341,2175,903,1272,367,95,177,1,8,6,15,10,19,4
R20324,í∑ñÏåß,óßâ»í¨,6612,3328,3284,6496,3256,3240,624,313,311,3529,1848,1681,2441,1157,1284,1244,541,703,107,35,113,0,4,3,3,5,6,1
R20349,í∑ñÏåß,ê¬ñÿë∫,4121,1976,2145,4091,1958,2133,478,230,248,2018,1024,994,1624,721,903,906,365,541,30,29,69,0,2,1,1,1,2,1
R20350,í∑ñÏåß,í∑òaí¨,5600,2774,2826,5552,2759,2793,524,266,258,2696,1416,1280,2380,1092,1288,1259,516,743,48,21,96,1,3,2,17,2,11,2
R20361,í∑ñÏåß,â∫êzñKí¨,19155,9238,9917,18825,9101,9724,2056,1052,1004,9581,4948,4633,7360,3141,4219,4400,1790,2610,234,85,287,3,13,14,32,22,42,3
R20362,í∑ñÏåß,ïxémå©í¨,14084,6839,7245,13820,6725,7095,1651,832,819,7229,3668,3561,5115,2285,2830,2846,1165,1681,214,83,191,1,8,4,31,5,24,5
R20363,í∑ñÏåß,å¥ë∫,7680,3771,3909,7552,3724,3828,979,523,456,4009,2022,1987,2667,1213,1454,1348,537,811,116,42,103,0,5,3,3,3,6,1
R20382,í∑ñÏåß,íCñÏí¨,18555,9016,9539,18166,8854,9312,2014,1014,1000,9499,4893,4606,6999,3094,3905,3903,1613,2290,353,85,291,1,12,11,18,13,28,6
R20383,í∑ñÏåß,ñ•ó÷í¨,24989,12511,12478,24199,12151,12048,3043,1584,1459,13137,6865,6272,7168,3196,3972,3744,1562,2182,743,137,242,1,13,9,24,10,41,8
R20384,í∑ñÏåß,î—ìáí¨,9004,4392,4612,8781,4286,4495,1003,531,472,4671,2395,2276,3329,1465,1864,1859,734,1125,223,44,129,0,5,4,4,4,8,3
R20385,í∑ñÏåß,ìÏñ•ó÷ë∫,15797,7851,7946,15463,7694,7769,2494,1266,1228,9492,4886,4606,3699,1629,2070,1884,775,1109,276,160,144,0,8,3,8,7,22,5
R20386,í∑ñÏåß,íÜêÏë∫,4651,2189,2462,4588,2175,2413,609,287,322,2365,1165,1200,1677,737,940,903,355,548,63,32,58,0,2,1,3,1,6,2
R20388,í∑ñÏåß,ã{ìcë∫,8569,4162,4407,8282,4037,4245,1190,627,563,4814,2426,2388,2543,1096,1447,1410,550,860,272,52,79,0,3,4,3,10,5,2
R20402,í∑ñÏåß,èºêÏí¨,12530,6069,6461,12416,6007,6409,1535,786,749,6667,3340,3327,4324,1941,2383,2400,995,1405,114,83,174,1,4,5,13,6,19,4
R20403,í∑ñÏåß,çÇêXí¨,12811,6153,6658,12602,6059,6543,1785,903,882,6777,3364,3413,4162,1825,2337,2332,924,1408,158,63,139,1,9,3,21,4,23,5
R20404,í∑ñÏåß,à¢ìÏí¨,4299,2071,2228,4258,2062,2196,393,211,182,1926,1010,916,1953,843,1110,1207,449,758,41,12,102,1,5,2,11,2,9,3
R20407,í∑ñÏåß,à¢íqë∫,6068,2894,3174,5941,2843,3098,794,425,369,3017,1497,1520,2257,972,1285,1246,457,789,127,42,98,0,7,1,3,1,6,4
R20409,í∑ñÏåß,ïΩíJë∫,387,192,195,384,189,195,46,27,19,210,108,102,131,57,74,89,32,57,3,0,9,0,1,0,0,0,0,0
R20410,í∑ñÏåß,ç™âHë∫,852,411,441,837,410,427,57,31,26,348,174,174,447,206,241,274,114,160,15,3,26,0,2,0,1,0,0,1
R20411,í∑ñÏåß,â∫ûäë∫,3545,1709,1836,3509,1702,1807,467,213,254,1832,924,908,1246,572,674,713,286,427,36,25,60,0,2,1,1,1,2,1
R20412,í∑ñÏåß,îÑñÿë∫,548,252,296,541,246,295,57,23,34,219,101,118,260,119,141,166,64,102,7,3,5,0,1,1,1,1,0,1
R20413,í∑ñÏåß,ìVó¥ë∫,1178,558,620,1165,552,613,72,40,32,374,203,171,732,315,417,486,184,302,11,3,36,0,1,0,0,0,0,1
R20414,í∑ñÏåß,ë◊ïåë∫,1542,726,816,1516,716,800,188,92,96,704,352,352,650,282,368,406,150,256,26,11,37,0,2,1,1,1,0,1
R20415,í∑ñÏåß,ã™ñÿë∫,5973,2908,3065,5915,2886,3029,803,405,398,3043,1578,1465,2126,924,1202,1192,479,713,57,43,75,0,3,2,2,2,7,3
R20416,í∑ñÏåß,ñLãuë∫,6426,3185,3241,6307,3141,3166,877,471,406,3432,1750,1682,2117,964,1153,1141,466,675,119,44,65,0,3,3,4,3,3,3
R20417,í∑ñÏåß,ëÂé≠ë∫,1023,539,484,1011,532,479,98,49,49,460,269,191,465,221,244,309,127,182,12,4,17,0,3,0,1,0,0,1
R20422,í∑ñÏåß,è„èºí¨,4131,2044,2087,4076,2034,2042,375,193,182,2003,1101,902,1753,750,1003,1003,371,632,55,12,84,0,4,1,2,1,4,1
R20423,í∑ñÏåß,ìÏñÿë]í¨,3915,1896,2019,3882,1883,1999,414,216,198,1806,946,860,1683,724,959,971,367,604,29,10,78,0,2,1,1,1,2,3
R20425,í∑ñÏåß,ñÿëcë∫,2692,1235,1457,2668,1231,1437,284,126,158,1240,615,625,1168,494,674,658,246,412,24,11,63,0,2,1,2,1,5,1
R20429,í∑ñÏåß,â§ëÍë∫,715,340,375,702,337,365,41,20,21,365,188,177,308,131,177,188,65,123,13,3,13,0,1,0,1,1,4,1
R20430,í∑ñÏåß,ëÂåKë∫,3439,1682,1757,3363,1637,1726,283,141,142,1673,897,776,1482,643,839,857,332,525,76,17,46,0,1,1,1,1,2,1
R20432,í∑ñÏåß,ñÿë]í¨,10584,5155,5429,10423,5107,5316,916,481,435,5090,2678,2412,4426,1901,2525,2484,925,1559,121,43,200,1,7,8,32,8,29,4
R20446,í∑ñÏåß,ñÉê—ë∫,2593,1219,1374,2575,1214,1361,241,132,109,1189,603,586,1163,484,679,735,272,463,18,10,83,0,2,2,1,2,5,1
R20448,í∑ñÏåß,ê∂ç‚ë∫,1639,818,821,1628,818,810,169,94,75,774,408,366,696,316,380,404,164,240,11,13,34,0,1,1,1,1,0,1
R20450,í∑ñÏåß,éRå`ë∫,8400,4103,4297,8237,4046,4191,1121,571,550,4830,2454,2376,2436,1070,1366,1170,460,710,163,65,109,0,5,2,6,3,10,2
R20451,í∑ñÏåß,í©ì˙ë∫,4279,2110,2169,4238,2096,2142,525,269,256,2379,1217,1162,1375,624,751,750,309,441,41,27,72,0,1,2,1,3,0,1
R20452,í∑ñÏåß,í}ñkë∫,4149,2046,2103,4121,2035,2086,314,169,145,1905,1034,871,1930,843,1087,1069,437,632,28,17,83,0,2,1,3,1,4,2
R20481,í∑ñÏåß,írìcí¨,9382,4552,4830,9258,4485,4773,926,489,437,4730,2409,2321,3708,1648,2060,1993,814,1179,120,39,152,1,7,3,58,6,34,2
R20482,í∑ñÏåß,èºêÏë∫,9599,4605,4994,9455,4551,4904,1069,534,535,5188,2590,2598,3305,1457,1848,1812,729,1083,134,49,95,0,8,5,11,6,13,2
R20485,í∑ñÏåß,îíînë∫,8575,4257,4318,8222,4046,4176,961,478,483,4726,2391,2335,2785,1319,1466,1354,591,763,292,44,96,0,7,3,8,4,10,1
R20486,í∑ñÏåß,è¨íJë∫,2647,1367,1280,2586,1332,1254,269,129,140,1364,762,602,1014,476,538,569,244,325,61,16,45,0,2,1,1,1,0,1
R20521,í∑ñÏåß,ç‚èÈí¨,14004,6909,7095,13607,6668,6939,1530,775,755,7333,3809,3524,5018,2249,2769,2786,1175,1611,377,66,194,0,11,5,8,5,29,3
R20541,í∑ñÏåß,è¨ïzé{í¨,10660,5122,5538,10611,5108,5503,1396,725,671,5504,2711,2793,3748,1676,2072,1973,828,1145,47,78,121,1,7,4,20,6,19,3
R20543,í∑ñÏåß,çÇéRë∫,6617,3242,3375,6519,3176,3343,718,383,335,3458,1753,1705,2441,1106,1335,1239,484,755,98,20,124,0,3,1,2,1,3,1
R20561,í∑ñÏåß,éRÉmì‡í¨,11352,5519,5833,11179,5478,5701,976,504,472,5580,2879,2701,4762,2121,2641,2669,1062,1607,163,45,192,0,5,3,4,3,5,5
R20562,í∑ñÏåß,ñÿìáïΩë∫,4375,2114,2261,4326,2098,2228,470,229,241,2074,1050,1024,1761,790,971,945,361,584,21,21,89,0,4,1,2,2,6,1
R20563,í∑ñÏåß,ñÏëÚâ∑êÚë∫,3279,1571,1708,3247,1553,1694,375,188,187,1629,829,800,1257,543,714,669,240,429,32,28,78,0,4,1,2,3,2,1
R20583,í∑ñÏåß,êMîZí¨,7739,3812,3927,7680,3786,3894,661,345,316,3661,1894,1767,3416,1572,1844,1741,718,1023,59,26,120,1,2,3,7,3,10,4
R20588,í∑ñÏåß,è¨êÏë∫,2215,1100,1115,2199,1093,1106,188,103,85,1010,543,467,1017,454,563,608,235,373,16,7,54,0,1,1,1,1,0,1
R20590,í∑ñÏåß,î—çjí¨,10296,5019,5277,10252,4996,5256,1019,510,509,5094,2592,2502,4182,1917,2265,2116,862,1254,43,40,153,1,4,3,12,6,20,3
R20602,í∑ñÏåß,âhë∫,1660,800,860,1645,797,848,103,57,46,654,344,310,902,398,504,554,198,356,15,6,49,0,3,1,1,1,0,1
R21201,äÚïååß,äÚïåés,402557,191679,210878,377921,180113,197808,45760,23410,22350,219393,106802,112591,113093,48199,64894,60239,23734,36505,6362,2652,4418,29,397,259,1736,467,1385,50
R21202,äÚïååß,ëÂä_és,158286,76994,81292,152167,73980,78187,20339,10483,9856,92709,46527,46182,43465,19024,24441,22665,9120,13545,4934,1127,1664,7,131,95,411,162,337,32
R21203,äÚïååß,çÇéRés,84419,40483,43936,83650,40146,43504,10547,5403,5144,45399,22824,22575,28093,11976,16117,15026,5787,9239,706,591,1085,3,76,35,186,44,156,24
R21204,äÚïååß,ëΩé°å©és,106732,51437,55295,104293,50364,53929,12253,6224,6029,60458,30141,30317,33321,14735,18586,16772,6809,9963,1870,638,1210,4,82,50,290,71,281,16
R21205,äÚïååß,ä÷és,85283,41657,43626,82699,40379,42320,10487,5377,5110,47961,24152,23809,25999,11603,14396,12885,5218,7667,1952,471,1057,2,70,31,192,51,127,19
R21206,äÚïååß,íÜí√êÏés,76570,37414,39156,74256,36295,37961,9113,4793,4320,41736,21486,20250,24980,10751,14229,13598,5260,8338,1755,426,1018,2,55,32,112,49,110,23
R21207,äÚïååß,î¸îZés,19247,9289,9958,18725,9045,9680,2112,1066,1046,10121,5074,5047,6973,3114,3859,3461,1374,2087,486,93,283,1,16,10,23,17,36,6
R21208,äÚïååß,êêòQés,37150,18156,18994,36064,17617,18447,4187,2180,2007,21105,10945,10160,11639,4927,6712,6248,2314,3934,941,234,437,2,31,20,80,33,57,10
R21209,äÚïååß,âHìáés,65649,32303,33346,64062,31460,32602,8480,4337,4143,38380,19398,18982,18140,8162,9978,8943,3704,5239,987,388,680,1,43,39,82,60,106,11
R21210,äÚïååß,åbìﬂés,47774,23138,24636,46751,22659,24092,5499,2814,2685,25118,12899,12219,16856,7261,9595,9076,3476,5600,818,241,678,2,41,20,59,33,55,16
R21211,äÚïååß,î¸îZâ¡ñŒés,56689,28141,28548,50418,24996,25422,8277,4076,4201,32868,16660,16208,12916,5775,7141,6554,2631,3923,4642,405,507,2,38,27,190,52,118,14
R21212,äÚïååß,ìyäÚés,55348,26803,28545,53526,25938,27588,6553,3352,3201,30878,15590,15288,17692,7715,9977,9487,3787,5700,1640,275,766,2,37,25,92,37,108,11
R21213,äÚïååß,äeñ±å¥és,144521,71220,73301,140275,68931,71344,18832,9645,9187,83147,42309,40838,40954,18282,22672,20916,9028,11888,2974,927,1385,5,115,60,235,105,315,18
R21214,äÚïååß,â¬éôés,99968,49202,50766,91223,44980,46243,12949,6639,6310,57717,29125,28592,27764,12735,15029,13154,5808,7346,7335,584,894,4,71,36,123,52,149,11
R21215,äÚïååß,éRåßés,25280,12184,13096,24668,12000,12668,2616,1362,1254,13520,6674,6846,9115,4142,4973,4563,1896,2667,593,110,352,1,23,10,44,16,34,7
R21216,äÚïååß,êêï‰és,56388,28105,28283,53139,26476,26663,8590,4425,4165,34645,17565,17080,11829,5367,6462,5663,2410,3253,2158,503,418,0,33,20,39,225,71,11
R21217,äÚïååß,îÚëÀés,22538,10860,11678,22407,10803,11604,2393,1214,1179,11032,5760,5272,9102,3875,5227,5270,2012,3258,122,100,341,2,25,7,25,9,42,7
R21218,äÚïååß,ñ{ëÉés,32928,15936,16992,32205,15616,16589,4187,2140,2047,18511,9252,9259,10038,4445,5593,4956,2047,2909,576,163,378,0,25,12,24,19,33,8
R21219,äÚïååß,åSè„és,38997,19051,19946,38474,18787,19687,4575,2319,2256,19746,10209,9537,14612,6467,8145,8085,3209,4876,493,221,644,4,27,15,68,17,60,14
R21220,äÚïååß,â∫òCés,30428,14471,15957,29921,14240,15681,3246,1656,1590,14670,7399,7271,12298,5275,7023,7087,2758,4329,463,146,493,2,27,13,61,15,48,6
R21221,äÚïååß,äCí√és,32735,16045,16690,32000,15686,16314,3270,1667,1603,18152,9207,8945,11257,5134,6123,5330,2206,3124,686,123,416,1,23,14,39,18,29,12
R21302,äÚïååß,äÚìÏí¨,25881,12664,13217,24976,12263,12713,3774,1913,1861,15941,7967,7974,5822,2626,3196,2980,1244,1736,574,271,188,0,26,13,38,17,39,6
R21303,äÚïååß,ä}èºí¨,22208,10513,11695,21670,10284,11386,2740,1399,1341,13011,6322,6689,6210,2655,3555,3431,1355,2076,321,163,234,2,19,13,167,18,80,4
R21341,äÚïååß,ó{òVí¨,26882,13116,13766,26413,12854,13559,2848,1479,1369,14822,7504,7318,9162,4094,5068,4348,1730,2618,438,93,364,1,15,11,37,21,30,10
R21361,äÚïååß,êÇà‰í¨,26402,12985,13417,25607,12570,13037,3272,1685,1587,14765,7531,7234,8280,3718,4562,4123,1725,2398,794,146,304,1,14,13,34,19,30,7
R21362,äÚïååß,ä÷ÉPå¥í¨,6610,3202,3408,6462,3132,3330,584,302,282,3338,1693,1645,2649,1180,1469,1373,562,811,139,17,107,0,5,4,10,4,11,2
R21381,äÚïååß,ê_åÀí¨,18585,9099,9486,18192,8922,9270,2177,1070,1107,10309,5244,5065,5973,2729,3244,2909,1272,1637,363,94,228,0,13,11,15,12,10,4
R21382,äÚïååß,ó÷îVì‡í¨,9654,4807,4847,9175,4509,4666,1300,651,649,5753,2999,2754,2571,1139,1432,1209,468,741,456,64,94,0,5,2,5,2,5,3
R21383,äÚïååß,à¿î™í¨,14355,7036,7319,14041,6883,7158,1875,956,919,8306,4186,4120,4111,1851,2260,2023,845,1178,275,67,147,0,11,6,12,6,15,6
R21401,äÚïååß,óKî„êÏí¨,19529,9366,10163,19306,9237,10069,1993,1022,971,10003,5040,4963,7523,3299,4224,3940,1524,2416,222,87,333,1,21,7,38,12,42,7
R21403,äÚïååß,ëÂñÏí¨,22041,10778,11263,21750,10627,11123,2794,1467,1327,12579,6333,6246,6608,2941,3667,3230,1348,1882,262,112,238,0,13,9,16,10,15,6
R21404,äÚïååß,írìcí¨,23360,11425,11935,22827,11143,11684,2976,1532,1444,13427,6821,6606,6911,3049,3862,3496,1418,2078,520,108,269,1,8,9,17,13,27,8
R21421,äÚïååß,ñkï˚í¨,18139,8652,9487,17702,8459,9243,2501,1271,1230,11063,5393,5670,4455,1917,2538,2201,860,1341,436,121,155,0,23,14,31,21,47,4
R21501,äÚïååß,ç‚èjí¨,8071,4168,3903,7506,3832,3674,1046,549,497,4686,2533,2153,2254,1028,1226,1046,419,627,503,54,75,0,5,2,3,2,3,2
R21502,äÚïååß,ïxâ¡í¨,5626,2705,2921,5491,2631,2860,792,405,387,3016,1515,1501,1817,784,1033,947,349,598,135,39,61,0,4,2,2,4,0,1
R21503,äÚïååß,êÏï”í¨,9860,4865,4995,9648,4742,4906,1239,660,579,5449,2772,2677,3158,1423,1735,1661,665,996,200,51,128,0,7,2,8,4,13,3
R21504,äÚïååß,éµè@í¨,3402,1608,1794,3375,1607,1768,283,148,135,1551,777,774,1568,683,885,869,338,531,27,10,83,0,4,1,4,1,1,2
R21505,äÚïååß,î™ïSí√í¨,10195,4905,5290,10050,4855,5195,999,511,488,5089,2579,2510,4097,1809,2288,2210,871,1339,139,39,190,1,11,2,9,3,12,4
R21506,äÚïååß,îíêÏí¨,7412,3485,3927,7308,3439,3869,586,285,301,3355,1677,1678,3471,1523,1948,2023,769,1254,104,21,150,1,4,1,7,2,8,6
R21507,äÚïååß,ìåîíêÏë∫,2016,964,1052,1996,952,1044,185,91,94,921,488,433,910,385,525,553,214,339,20,10,37,0,2,0,2,0,0,1
R21521,äÚïååß,å‰êìí¨,17516,8770,8746,16906,8448,8458,2090,1095,995,9755,5056,4699,5565,2542,3023,2720,1135,1585,529,98,193,1,11,5,13,11,15,4
R21604,äÚïååß,îíêÏë∫,1511,755,756,1482,746,736,201,93,108,810,443,367,500,219,281,264,110,154,29,9,18,0,3,1,1,1,0,2
R22100,ê√â™åß,ê√â™és,693389,337812,355577,676457,329508,346949,78274,40321,37953,395897,200965,194932,209628,91095,118533,111391,44246,67145,9764,4254,8239,22,548,343,1814,504,1811,160
R22130,ê√â™åß,ïlèºés,790718,392900,397818,764849,380278,384571,101461,52415,49046,457684,235578,222106,220925,98712,122213,115331,47046,68285,22368,5365,8454,25,649,386,2351,539,1837,126
R22203,ê√â™åß,è¿í√és,189386,93046,96340,183966,90388,93578,19162,9690,9472,107423,55661,51762,60488,26398,34090,31773,12530,19243,4042,1035,2443,8,149,127,388,167,479,34
R22205,ê√â™åß,îMäCés,34208,15438,18770,33383,15084,18299,1993,1008,985,15252,7445,7807,16376,6658,9718,9544,3508,6036,494,86,724,5,36,23,133,33,80,6
R22206,ê√â™åß,éOìáés,107783,52421,55362,105537,51387,54150,13054,6665,6389,61582,31152,30430,31677,13910,17767,16327,6675,9652,1192,653,1202,5,90,60,159,72,285,21
R22207,ê√â™åß,ïxémã{és,128105,63364,64741,125528,62020,63508,15768,8111,7657,73531,38055,35476,37925,16656,21269,18709,7497,11212,1914,717,1486,3,93,58,181,66,263,23
R22208,ê√â™åß,à…ìåés,65491,30668,34823,64442,30242,34200,5503,2835,2668,30839,15256,15583,27965,12019,15946,15093,6002,9091,494,236,1079,2,55,46,102,51,116,10
R22209,ê√â™åß,ìáìcés,95719,46725,48994,94095,46026,48069,12022,6104,5918,53013,26955,26058,30176,13347,16829,15877,6399,9478,1306,610,1198,1,65,39,166,54,205,20
R22210,ê√â™åß,ïxémés,245392,120694,124698,239087,117801,121286,30431,15511,14920,143917,73864,70053,69314,30522,38792,35530,14127,21403,4998,1567,2676,9,172,128,401,151,549,43
R22211,ê√â™åß,î÷ìcés,166672,83980,82692,157073,78871,78202,21544,11040,10504,94843,49623,45220,47581,21710,25871,23393,9792,13601,7346,1040,1778,6,120,68,326,86,295,26
R22212,ê√â™åß,èƒí√és,136845,66952,69893,131992,64679,67313,16571,8546,8025,78621,39991,38630,40865,18017,22848,20998,8668,12330,4355,791,1548,4,83,56,251,78,344,13
R22213,ê√â™åß,ä|êÏés,114954,57655,57299,110464,55464,55000,15655,8010,7645,66367,34432,31935,32043,14668,17375,15638,6374,9264,4090,808,1202,3,75,48,232,65,232,18
R22214,ê√â™åß,ì°é}és,141342,68793,72549,139161,67796,71365,18165,9211,8954,79594,39960,39634,42602,19133,23469,21481,9159,12322,1618,836,1568,4,101,59,323,77,436,24
R22215,ê√â™åß,å‰ìaèÍés,86614,44454,42160,84088,43270,40818,11327,5732,5595,52570,28596,23974,22176,9788,12388,11388,4549,6839,2100,629,829,7,46,36,117,50,233,18
R22216,ê√â™åß,ë‹à‰és,87864,44534,43330,82773,41950,40823,12764,6637,6127,52796,27597,25199,21310,9796,11514,10150,4144,6006,4336,672,792,2,63,26,78,49,132,18
R22219,ê√â™åß,â∫ìcés,20183,9675,10508,19971,9593,10378,1684,862,822,9887,5165,4722,8535,3598,4937,4697,1780,2917,173,69,354,2,22,11,41,14,44,4
R22220,ê√â™åß,êûñÏés,50911,25773,25138,49896,25271,24625,6853,3436,3417,30028,15964,14064,13667,6205,7462,6641,2805,3836,712,385,479,2,35,20,55,25,89,9
R22221,ê√â™åß,åŒêºés,57885,29625,28260,54565,27790,26775,6973,3570,3403,34646,18565,16081,16070,7394,8676,7829,3308,4521,3284,335,583,2,43,22,60,29,76,10
R22222,ê√â™åß,à…ì§és,28190,13342,14848,27992,13281,14711,2328,1152,1176,13861,6961,6900,11999,5227,6772,6437,2502,3935,197,116,475,5,16,12,41,17,55,7
R22223,ê√â™åß,å‰ëOçËés,31103,15803,15300,29928,15225,14703,3673,1869,1804,17564,9401,8163,9537,4309,5228,4652,1825,2827,914,167,400,1,18,10,38,17,48,5
R22224,ê√â™åß,ãeêÏés,47789,24173,23616,44020,22263,21757,6711,3382,3329,27785,14609,13176,12864,5923,6941,6191,2571,3620,3473,336,483,1,28,20,66,18,84,11
R22225,ê√â™åß,à…ì§ÇÃçëés,46804,22459,24345,45977,22033,23944,5328,2739,2589,25354,12635,12719,15750,6852,8898,8101,3213,4888,554,238,604,6,29,25,308,29,152,7
R22226,ê√â™åß,ñqîVå¥és,43502,21414,22088,41325,20296,21029,5064,2572,2492,24348,12643,11705,13834,6071,7763,7030,2696,4334,1968,210,605,1,32,19,54,29,61,14
R22301,ê√â™åß,ìåà…ì§í¨,11488,5440,6048,11348,5402,5946,774,356,418,5189,2630,2559,5516,2448,3068,3007,1219,1788,140,25,266,2,8,5,18,6,13,1
R22302,ê√â™åß,âÕí√í¨,6870,3317,3553,6826,3302,3524,644,325,319,3266,1661,1605,2960,1331,1629,1572,644,928,44,29,129,1,6,5,17,8,17,1
R22304,ê√â™åß,ìÏà…ì§í¨,7877,3722,4155,7829,3705,4124,659,309,350,3339,1721,1618,3873,1689,2184,2047,785,1262,45,29,166,0,10,2,12,2,10,2
R22305,ê√â™åß,èºçËí¨,6038,2837,3201,6016,2831,3185,463,245,218,2620,1325,1295,2948,1260,1688,1644,639,1005,21,14,117,0,5,4,2,4,5,1
R22306,ê√â™åß,êºà…ì§í¨,7090,3352,3738,6996,3311,3685,435,217,218,2972,1540,1432,3654,1579,2075,2019,810,1209,88,19,189,1,5,5,13,5,12,2
R22325,ê√â™åß,îüìÏí¨,36794,17916,18878,36503,17766,18737,4286,2219,2067,20397,10289,10108,12069,5378,6691,6132,2537,3595,282,236,448,2,23,18,60,27,87,5
R22341,ê√â™åß,ê¥êÖí¨,31710,15388,16322,30294,14676,15618,4012,2135,1877,19101,9476,9625,8285,3591,4694,4480,1828,2652,1154,212,381,2,23,24,111,33,89,5
R22342,ê√â™åß,í∑êÚí¨,43336,21434,21902,42629,21103,21526,6880,3496,3384,26520,13525,12995,9556,4228,5328,5120,2099,3021,401,415,396,2,28,20,285,34,259,8
R22344,ê√â™åß,è¨éRí¨,18568,9845,8723,18372,9769,8603,2165,1101,1064,10794,6282,4512,5569,2424,3145,2921,1098,1823,196,97,213,2,7,6,22,10,20,6
R22424,ê√â™åß,ãgìcí¨,28919,14413,14506,27238,13683,13555,3689,1900,1789,17590,9118,8472,7468,3303,4165,3643,1422,2221,1555,178,302,1,16,9,21,17,42,4
R22429,ê√â™åß,êÏç™ñ{í¨,6206,3055,3151,6119,3034,3085,403,201,202,2727,1484,1243,3076,1370,1706,1892,747,1145,87,15,143,0,6,4,5,2,5,3
R22461,ê√â™åß,êXí¨,17457,8699,8758,17078,8460,8618,2005,1056,949,9341,4859,4482,6001,2712,3289,3129,1237,1892,341,73,240,1,10,6,20,8,20,2
R23100,à§ímåß,ñºå√âÆés,2332176,1146669,1185507,2184995,1074998,1109997,275484,140965,134519,1388348,704963,683385,566154,247113,319041,298183,117570,180613,69501,17538,23120,113,2148,1435,7746,2599,6719,502
R23201,à§ímåß,ñLã¥és,371920,186160,185760,350303,174992,175311,48558,24797,23761,221467,115065,106402,95757,42579,53178,47980,19550,28430,16916,2527,3680,17,254,178,795,272,716,63
R23202,à§ímåß,â™çËés,384654,193719,190935,368415,186304,182111,54174,27921,26253,234846,122478,112368,89678,40722,48956,42964,18003,24961,10887,2852,3104,13,235,160,655,234,724,56
R23203,à§ímåß,àÍã{és,380073,184934,195139,368050,178865,189185,48805,25082,23723,221207,110247,110960,102543,45158,57385,54198,22556,31642,5774,2599,3824,14,258,182,898,274,735,70
R23204,à§ímåß,ê£åÀés,127792,62586,65206,122745,60186,62559,15806,8102,7704,72686,37131,35555,38195,16895,21300,20090,8461,11629,3971,697,1336,7,67,58,313,95,304,25
R23205,à§ímåß,îºìcés,117884,59364,58520,112672,56564,56108,15247,7923,7324,72492,37631,34861,28591,12861,15730,14467,6000,8467,3862,866,1122,3,82,49,235,83,217,20
R23206,à§ímåß,ètì˙à‰és,308681,152320,156361,297652,146989,150663,40928,20884,20044,182975,93376,89599,79532,35534,43998,41392,17815,23577,6657,2393,2775,11,208,134,589,206,605,51
R23207,à§ímåß,ñLêÏés,184661,91964,92697,177239,88142,89097,25338,12869,12469,109442,56579,52863,48237,21418,26819,24529,10163,14366,6115,1466,1852,12,101,77,323,121,329,46
R23208,à§ímåß,í√ìáés,60942,29664,31278,59227,28873,30354,6588,3450,3138,35520,18011,17509,18299,7923,10376,9800,3947,5853,1347,286,778,4,53,34,154,48,153,12
R23209,à§ímåß,ï…ìÏés,72458,37286,35172,66802,34189,32613,9872,5120,4752,44522,23870,20652,17247,7753,9494,8850,3550,5300,5045,492,682,4,43,36,120,51,126,15
R23210,à§ímåß,ä†íJés,153834,80203,73631,147066,76934,70132,20887,10725,10162,96421,52206,44215,31028,14212,16816,15141,6436,8705,4708,1385,1146,6,93,61,377,106,275,35
R23211,à§ímåß,ñLìcés,422330,220716,201614,400702,209599,191103,56365,28893,27472,261645,142113,119532,97411,45347,52064,45781,20247,25534,15974,3080,3167,14,229,145,587,255,681,84
R23212,à§ímåß,à¿èÈés,187990,96093,91897,179259,91832,87427,27665,14261,13404,119010,63087,55923,39497,17926,21571,19143,8040,11103,7101,1613,1419,2,120,81,426,122,332,41
R23213,à§ímåß,êºîˆés,169046,85594,83452,159336,80273,79063,23576,12041,11535,100848,53218,47630,43373,19548,23825,21591,8814,12777,8909,1135,1601,5,87,68,176,101,225,36
R23214,à§ímåß,äóåSés,79538,39336,40202,75822,37637,38185,9583,5079,4504,45717,23674,22043,23404,10177,13227,12717,5091,7626,3025,460,936,3,58,44,132,58,149,18
R23215,à§ímåß,å¢éRés,73090,36240,36850,70376,34728,35648,8825,4465,4360,42172,21793,20379,21416,9523,11893,11321,4907,6414,2218,408,786,4,48,30,115,50,110,14
R23216,à§ímåß,èÌääés,58710,28575,30135,56500,27576,28924,8495,4346,4149,34460,17309,17151,14737,6465,8272,7948,3183,4765,1273,402,595,1,40,22,85,38,83,15
R23217,à§ímåß,ç]ìÏés,98255,47920,50335,93572,45917,47655,11679,5934,5745,54529,27172,27357,26630,11870,14760,13857,5922,7935,1544,585,1017,2,71,54,252,95,204,19
R23219,à§ímåß,è¨ñqés,148831,75290,73541,138972,70448,68524,19321,9824,9497,91387,47984,43403,37160,16886,20274,18565,8087,10478,9011,901,1267,3,99,65,275,111,242,23
R23220,à§ímåß,àÓëÚés,134751,66415,68336,130832,64421,66411,17241,8850,8391,79173,40220,38953,37287,16845,20442,18965,8117,10848,3083,928,1340,4,98,66,205,99,229,32
R23221,à§ímåß,êVèÈés,44355,22002,22353,43264,21444,21820,4732,2444,2288,23319,12073,11246,16032,7295,8737,8350,3427,4923,885,184,653,4,35,23,62,29,77,15
R23222,à§ímåß,ìåäCés,113787,59158,54629,110079,57405,52674,16453,8563,7890,69809,37949,31860,25005,11383,13622,12947,5503,7444,1753,946,925,2,73,52,178,79,162,21
R23223,à§ímåß,ëÂï{és,93123,47374,45749,88574,44869,43705,14194,7166,7028,57143,30072,27071,19927,9047,10880,10261,4419,5842,2611,875,674,3,65,34,295,72,310,25
R23224,à§ímåß,ímëΩés,84364,42346,42018,81839,41183,40656,10966,5760,5206,49179,25403,23776,23461,10791,12670,11785,5275,6510,1902,573,831,3,42,34,57,51,104,15
R23225,à§ímåß,ímóßés,72193,38127,34066,66343,35064,31279,9755,5139,4616,46716,25555,21161,14360,6598,7762,7233,3075,4158,4729,595,555,2,33,30,57,43,83,13
R23226,à§ímåß,îˆí£àÆés,83144,40453,42691,81078,39479,41599,11404,5812,5592,49283,24530,24753,21475,9551,11924,11085,4750,6335,1309,585,702,1,68,48,123,64,150,15
R23227,à§ímåß,çÇïlés,46106,23790,22316,42490,21935,20555,6997,3580,3417,29738,15949,13789,8896,3998,4898,4488,1800,2688,3290,352,368,1,26,14,36,22,37,11
R23228,à§ímåß,ä‚ëqés,47983,23866,24117,44522,22176,22346,5890,2995,2895,28702,14734,13968,11995,5412,6583,6150,2634,3516,2321,418,453,1,29,25,43,38,61,11
R23229,à§ímåß,ñLñæés,69295,35061,34234,65397,32946,32451,8577,4493,4084,41574,21736,19838,18123,8230,9893,9482,4100,5382,3021,534,550,2,43,33,777,66,251,14
R23230,à§ímåß,ì˙êiés,91520,45149,46371,89895,44286,45609,13492,6911,6581,51836,25798,26038,18044,8005,10039,9529,4078,5451,1396,887,604,3,73,53,126,80,191,18
R23231,à§ímåß,ìcå¥és,59360,30138,29222,57899,29622,28277,7422,3830,3592,33453,17679,15774,16698,7533,9165,8404,3335,5069,1152,356,705,1,36,24,74,35,65,21
R23232,à§ímåß,à§êºés,60829,29536,31293,59796,29057,30739,6865,3429,3436,34544,17300,17244,19192,8680,10512,10166,4440,5726,838,273,749,0,39,25,38,28,65,13
R23233,à§ímåß,ê¥ê{és,67352,33520,33832,61185,30723,30462,8696,4454,4242,36320,18457,17863,15188,6764,8424,7742,3222,4520,1201,732,622,2,43,37,66,59,104,14
R23234,à§ímåß,ñkñºå√âÆés,86385,43041,43344,83633,41752,41881,12192,6250,5942,52510,27184,25326,20797,9236,11561,11133,4823,6310,1950,703,706,2,47,37,98,61,154,12
R23235,à§ímåß,ñÌïxés,43025,21465,21560,40802,20184,20618,5294,2675,2619,25765,13413,12352,11260,4969,6291,5904,2481,3423,1521,315,434,2,31,20,201,28,111,10
R23236,à§ímåß,Ç›ÇÊÇµés,61952,32105,29847,58362,30319,28043,8981,4653,4328,40028,21269,18759,11234,5352,5882,5483,2504,2979,2026,474,376,2,43,26,58,36,83,10
R23237,à§ímåß,Ç†Ç‹és,86126,42561,43565,83979,41431,42548,11511,5922,5589,51573,26360,25213,23031,10271,12760,11983,5259,6724,2048,681,843,1,52,31,95,46,114,12
R23238,à§ímåß,í∑ãvéËés,60162,29144,31018,55657,27031,28626,10084,5092,4992,36234,17736,18498,9840,4401,5439,4788,2011,2777,737,636,313,2,48,27,649,62,191,11
R23302,à§ímåß,ìåãΩí¨,43903,21931,21972,42122,21070,21052,6537,3331,3206,26144,13459,12685,10206,4567,5639,5190,2259,2931,1220,318,348,1,30,19,47,35,60,9
R23342,à§ímåß,ñLéRí¨,15613,7937,7676,14728,7551,7177,2285,1165,1120,8756,4557,4199,3444,1550,1894,1756,762,994,430,127,124,0,8,8,8,11,22,3
R23361,à§ímåß,ëÂå˚í¨,24305,12261,12044,23585,11938,11647,3456,1808,1648,13797,7127,6670,5769,2598,3171,3090,1336,1754,608,206,187,1,16,10,34,14,36,4
R23362,à§ímåß,ï}åKí¨,34133,16839,17294,33289,16440,16849,4616,2322,2294,20033,10272,9761,8992,3997,4995,4842,2114,2728,424,260,358,0,20,17,24,27,49,7
R23424,à§ímåß,ëÂé°í¨,32399,16304,16095,30915,15594,15321,4890,2471,2419,19868,10310,9558,6667,3062,3605,3276,1461,1815,696,275,261,0,13,8,12,15,21,5
R23425,à§ímåß,äIç]í¨,37338,18428,18910,35190,17330,17860,4552,2354,2198,22565,11421,11144,9473,4220,5253,4826,2001,2825,1415,236,345,2,26,15,40,26,60,9
R23427,à§ímåß,îÚìáë∫,4575,2251,2324,4328,2096,2232,647,334,313,2504,1301,1203,1419,611,808,742,280,462,246,33,53,0,5,2,6,2,3,2
R23441,à§ímåß,à¢ãvî‰í¨,28383,13965,14418,27890,13710,14180,4817,2490,2327,15837,8010,7827,7513,3334,4179,3891,1645,2246,305,208,263,0,21,10,30,14,52,9
R23442,à§ímåß,ìåâYí¨,49596,24726,24870,47856,23842,24014,6701,3396,3305,29566,15315,14251,12836,5803,7033,6546,2846,3700,1314,354,508,0,25,18,31,24,67,9
R23445,à§ímåß,ìÏímëΩí¨,16617,8079,8538,16196,7875,8321,1471,740,731,8614,4455,4159,6451,2835,3616,3415,1326,2089,389,56,265,0,12,9,19,12,16,6
R23446,à§ímåß,î¸ïlí¨,22496,11213,11283,21975,10909,11066,2216,1190,1026,12971,6642,6329,6820,3067,3753,3493,1428,2065,306,96,274,2,8,9,16,13,19,7
R23447,à§ímåß,ïêñLí¨,43535,22116,21419,41900,21162,20738,5869,2976,2893,26033,13787,12246,10795,4843,5952,5427,2328,3099,1109,304,395,2,21,15,28,24,77,10
R23501,à§ímåß,çKìcí¨,42449,21504,20945,41137,20822,20315,6979,3575,3404,26024,13581,12443,9198,4184,5014,4370,1795,2575,1233,384,306,0,27,14,47,20,44,9
R23561,à§ímåß,ê›äyí¨,4437,2165,2272,4394,2134,2260,328,169,159,1828,979,849,2263,999,1264,1363,537,826,26,10,111,0,7,4,3,4,1,4
R23562,à§ímåß,ìåâhí¨,2942,1417,1525,2925,1409,1516,256,146,110,1176,611,565,1490,640,850,881,318,563,17,12,79,0,4,1,4,1,5,1
R23563,à§ímåß,ñLç™ë∫,1017,482,535,997,474,523,80,39,41,404,213,191,533,230,303,311,115,196,20,2,31,0,2,1,2,0,0,1
R24201,éOèdåß,í√és,274537,133537,141000,263787,127855,135932,33180,17085,16095,156532,79044,77488,80745,35083,45662,43311,17366,25945,7377,1701,3226,19,269,137,1157,221,747,62
R24202,éOèdåß,élì˙ésés,305424,152669,152755,292356,146386,145970,37575,19202,18373,184945,96747,88198,78647,34803,43844,40418,16670,23748,8530,2106,3157,12,260,141,762,208,635,56
R24203,éOèdåß,à…ê®és,122765,58161,64604,120782,57182,63600,14205,7228,6977,68102,33445,34657,39098,16669,22429,21136,8192,12944,991,766,1513,4,132,77,414,117,269,35
R24204,éOèdåß,èºç„és,159145,76360,82785,154343,74296,80047,19629,10142,9487,90248,44555,45693,47785,20828,26957,25358,10099,15259,3859,1059,1930,7,147,73,484,118,366,35
R24205,éOèdåß,åKñºés,138613,68084,70529,133240,65286,67954,17826,9108,8718,81466,41113,40353,37083,16542,20541,18853,7790,11063,3707,897,1354,8,96,67,292,100,291,26
R24207,éOèdåß,óÈé≠és,195670,97350,98320,178822,89456,89366,22929,11660,11269,108792,55252,53540,47973,21515,26458,23791,10150,13641,6432,1343,1828,7,149,78,413,107,411,42
R24208,éOèdåß,ñºí£és,76387,36853,39534,75035,36170,38865,9146,4639,4507,41820,20651,21169,24835,11232,13603,11629,4855,6774,965,419,806,2,65,38,104,54,134,17
R24209,éOèdåß,îˆòhés,16252,7562,8690,15903,7407,8496,1396,700,696,7323,3623,3700,7122,2994,4128,4062,1581,2481,184,64,307,1,20,9,33,9,31,7
R24210,éOèdåß,ãTéRés,49835,25161,24674,46951,23706,23245,6292,3261,3031,26400,13749,12651,12773,5712,7061,6402,2621,3781,1658,337,555,3,35,17,45,21,65,14
R24211,éOèdåß,íπâHés,17525,8255,9270,17282,8160,9122,1596,852,744,8890,4401,4489,6885,2906,3979,3654,1337,2317,165,69,296,0,18,7,15,12,10,7
R24212,éOèdåß,åFñÏés,15965,7384,8581,15833,7327,8506,1525,759,766,7265,3608,3657,7113,2974,4139,4093,1533,2560,104,84,285,0,27,10,26,13,16,7
R24214,éOèdåß,Ç¢Ç»Ç◊és,44973,23106,21867,42758,21816,20942,5479,2826,2653,26529,14433,12096,12301,5461,6840,6206,2519,3687,1842,285,500,3,24,16,76,17,72,13
R24215,éOèdåß,éuñÄés,46057,21206,24851,45497,21003,24494,3968,1989,1979,22746,11025,11721,18818,7911,10907,10416,3972,6444,330,180,797,3,44,27,79,37,63,13
R24216,éOèdåß,à…âÍés,88766,43446,45320,82535,40093,42442,9603,4886,4717,47834,24912,22922,28933,12426,16507,15365,5862,9503,4993,499,1257,3,70,33,148,42,187,30
R24303,éOèdåß,ñÿë]ñ¶í¨,6023,3032,2991,5494,2722,2772,540,264,276,3118,1646,1472,2010,900,1110,983,412,571,302,19,68,0,3,2,4,2,2,1
R24324,éOèdåß,ìåàıí¨,25784,12614,13170,25189,12269,12920,3520,1783,1737,14229,7110,7119,8011,3700,4311,3517,1564,1953,593,189,224,0,14,10,28,12,44,6
R24341,éOèdåß,å‘ñÏí¨,40559,19868,20691,39310,19149,20161,5598,2840,2758,23816,12094,11722,10630,4644,5986,5569,2232,3337,770,311,417,1,22,13,50,16,54,8
R24343,éOèdåß,í©ì˙í¨,11021,5488,5533,10810,5353,5457,2069,1027,1042,6797,3511,3286,2104,918,1186,1166,497,669,164,101,94,0,7,4,7,4,4,1
R24344,éOèdåß,êÏâzí¨,15123,7798,7325,14545,7446,7099,2173,1128,1045,10045,5414,4631,2848,1227,1621,1497,571,926,543,144,121,0,8,5,10,7,7,4
R24441,éOèdåß,ëΩãCí¨,14021,6753,7268,13882,6712,7170,1752,905,847,7320,3693,3627,4848,2066,2782,2662,1004,1658,138,63,191,0,9,6,11,11,8,6
R24442,éOèdåß,ñæòaí¨,22445,10666,11779,22193,10537,11656,2906,1481,1425,12450,6122,6328,7009,3031,3978,3725,1459,2266,176,164,261,2,14,8,35,9,27,5
R24443,éOèdåß,ëÂë‰í¨,8668,4103,4565,8557,4074,4483,807,407,400,4093,2047,2046,3755,1645,2110,2172,857,1315,103,39,182,1,9,5,14,4,21,4
R24461,éOèdåß,ã èÈí¨,15041,7184,7857,14806,7102,7704,2096,1088,1008,8548,4174,4374,4258,1842,2416,2222,875,1347,164,97,151,1,11,7,12,7,24,4
R24470,éOèdåß,ìxâÔí¨,7847,3798,4049,7790,3788,4002,878,471,407,4120,2067,2053,2834,1252,1582,1476,563,913,46,36,106,0,5,3,3,3,2,3
R24471,éOèdåß,ëÂãIí¨,7815,3652,4163,7731,3614,4117,565,307,258,3312,1648,1664,3934,1693,2241,2368,930,1438,83,20,194,0,9,1,8,1,4,5
R24472,éOèdåß,ìÏà…ê®í¨,10989,5095,5894,10905,5075,5830,648,338,310,4442,2268,2174,5867,2471,3396,3664,1411,2253,79,32,264,1,10,5,12,6,11,4
R24543,éOèdåß,ãIñkí¨,14604,6758,7846,14313,6633,7680,1165,601,564,6692,3283,3409,6686,2819,3867,3910,1489,2421,275,40,343,2,15,8,19,11,20,7
R24561,éOèdåß,å‰ïlí¨,8079,3765,4314,8032,3762,4270,859,435,424,3916,1948,1968,3301,1381,1920,1853,690,1163,46,28,145,1,6,3,31,5,21,2
R24562,éOèdåß,ãIïÛí¨,10321,4767,5554,10195,4751,5444,1165,607,558,5262,2541,2721,3867,1605,2262,2025,742,1283,102,49,144,0,6,6,6,6,4,5
R25201,é†âÍåß,ëÂí√és,345070,166673,178397,334545,161092,173453,45482,23222,22260,200166,98283,101883,90578,40020,50558,44776,18242,26534,4035,2419,3173,13,296,141,1357,231,921,88
R25202,é†âÍåß,ïFç™és,113647,56492,57155,109859,54673,55186,14888,7703,7185,67948,34951,32997,28299,12532,15767,14455,5832,8623,2274,772,1042,3,94,52,211,68,255,28
R25203,é†âÍåß,í∑ïlés,113636,55406,58230,108099,52697,55402,14546,7521,7025,63648,31872,31776,32349,14251,18098,17201,6874,10327,3253,815,1221,3,92,49,293,69,236,24
R25204,é†âÍåß,ãﬂç]î™î¶és,81122,39676,41446,79187,38686,40501,11335,5729,5606,46578,23559,23019,22493,10043,12450,11021,4515,6506,1376,618,817,2,55,31,209,42,197,18
R25206,é†âÍåß,ëêí√és,143913,72646,71267,133964,67692,66272,19712,10158,9554,86272,45213,41059,30057,13499,16558,14730,6348,8382,2306,1083,890,5,131,63,297,100,492,28
R25207,é†âÍåß,éÁéRés,83236,40872,42364,81266,39947,41319,13642,6963,6679,50266,25001,25265,18098,8217,9881,8691,3784,4907,1025,731,607,3,67,31,242,53,209,15
R25208,é†âÍåß,åIìåés,68820,34110,34710,67317,33355,33962,11355,5784,5571,43973,22235,21738,13138,5923,7215,6227,2667,3560,1297,798,454,1,50,26,179,39,180,16
R25209,é†âÍåß,çbâÍés,88358,44014,44344,84041,41585,42456,11240,5867,5373,50912,26203,24709,24909,11177,13732,12634,5066,7568,3201,586,945,4,56,33,177,53,257,22
R25210,é†âÍåß,ñÏèFés,50513,25121,25392,49474,24586,24888,7139,3726,3413,29647,15186,14461,13189,5989,7200,6425,2802,3623,599,419,437,2,42,18,83,21,93,11
R25211,é†âÍåß,åŒìÏés,54460,28168,26292,50648,26046,24602,7187,3747,3440,33062,17662,15400,13387,6234,7153,5967,2547,3420,3083,381,441,2,33,18,40,20,76,15
R25212,é†âÍåß,çÇìáés,46377,22762,23615,45715,22420,23295,4959,2610,2349,24449,12514,11935,16648,7454,9194,8874,3561,5313,462,248,646,3,42,18,85,29,84,14
R25213,é†âÍåß,ìåãﬂç]és,112819,56296,56523,107969,53604,54365,15176,7795,7381,65768,34027,31741,30209,13480,16729,15125,6048,9077,3536,818,1075,7,73,42,203,61,178,22
R25214,é†âÍåß,ïƒå¥és,37225,18051,19174,36417,17711,18706,4759,2445,2314,20960,10523,10437,11058,4840,6218,6008,2355,3653,524,268,480,0,26,15,26,21,44,10
R25383,é†âÍåß,ì˙ñÏí¨,20964,10555,10409,20149,10055,10094,2575,1343,1232,11656,6125,5531,6424,2886,3538,3281,1294,1987,557,139,242,1,12,7,37,9,43,5
R25384,é†âÍåß,ó≥â§í¨,11789,6192,5597,11650,6110,5540,1506,786,720,6897,3842,3055,3315,1516,1799,1517,624,893,98,68,130,0,8,5,17,5,15,2
R25425,é†âÍåß,à§ëëí¨,20893,10373,10520,18815,9377,9438,3150,1590,1560,11474,5856,5618,4595,2032,2563,2296,896,1400,798,145,173,0,11,7,8,12,25,6
R25441,é†âÍåß,ñLãΩí¨,7132,3458,3674,6908,3321,3587,1035,512,523,4069,2051,2018,1983,869,1114,960,372,588,188,42,77,1,4,0,26,1,24,2
R25442,é†âÍåß,çbó«í¨,6362,3060,3302,6243,3012,3231,714,377,337,3477,1734,1743,2118,925,1193,1052,409,643,55,27,81,0,2,1,3,1,1,2
R25443,é†âÍåß,ëΩâÍí¨,7274,3504,3770,7235,3490,3745,969,494,475,3559,1782,1777,2464,1075,1389,1305,495,810,37,60,108,0,6,2,3,3,22,2
R26100,ãûìsï{,ãûìsés,1463723,692279,771444,1369358,644756,724602,153005,78495,74510,847046,412684,434362,394406,165609,228797,209563,80271,129292,39386,9251,14880,90,1594,811,6880,1271,4664,279
R26201,ãûìsï{,ïüíméRés,77306,38504,38802,75194,37445,37749,10041,5118,4923,42693,22462,20231,22974,9923,13051,12217,4710,7507,979,585,954,5,72,39,196,45,152,26
R26202,ãûìsï{,ïëíﬂés,80336,40244,40092,78084,39108,38976,9756,4870,4886,43185,23278,19907,25438,10906,14532,13714,5375,8339,836,572,1004,7,60,35,174,58,174,16
R26203,ãûìsï{,àªïîés,31846,15239,16607,31169,14950,16219,3462,1761,1701,15767,8029,7738,12313,5259,7054,6964,2720,4244,431,196,496,3,27,13,73,19,53,9
R26204,ãûìsï{,âFé°és,179630,86301,93329,177026,85020,92006,21985,11434,10551,103635,51306,52329,53800,23466,30334,27408,11431,15977,2533,1107,1796,8,132,81,442,145,353,26
R26205,ãûìsï{,ã{í√és,16758,7942,8816,16620,7902,8718,1595,832,763,7873,4028,3845,7245,3046,4199,4136,1539,2597,126,86,318,1,22,7,23,6,15,8
R26206,ãûìsï{,ãTâ™és,86174,41654,44520,84393,40852,43541,10707,5512,5195,48207,23810,24397,25959,11710,14249,12247,5151,7096,836,517,876,5,61,36,114,51,118,17
R26207,ãûìsï{,èÈózés,74607,35864,38743,73382,35213,38169,8530,4431,4099,40018,19704,20314,25105,11153,13952,12597,5492,7105,633,428,785,5,59,31,139,42,130,10
R26208,ãûìsï{,å¸ì˙és,56859,27119,29740,55852,26654,29198,7849,4015,3834,32857,16052,16805,15164,6546,8618,7815,3229,4586,470,458,530,1,46,26,65,33,105,10
R26209,ãûìsï{,í∑â™ãûés,80608,38793,41815,79500,38196,41304,11065,5623,5442,46950,23233,23717,22021,9576,12445,11516,4825,6691,627,610,678,4,73,41,195,54,204,15
R26210,ãûìsï{,î™î¶és,70433,34030,36403,68543,32990,35553,8188,4147,4041,39701,19809,19892,22054,9848,12206,10677,4646,6031,1572,323,680,4,41,27,94,43,115,15
R26211,ãûìsï{,ãûìcï”és,73753,36111,37642,70681,34483,36198,10641,5485,5156,43138,21480,21658,17311,7655,9656,8689,3783,4906,915,481,553,4,57,32,133,42,204,8
R26212,ãûìsï{,ãûíOå„és,50860,24357,26503,50235,24157,26078,5662,2901,2761,25593,13096,12497,19292,8182,11110,10874,4095,6779,414,291,758,4,33,18,79,29,67,15
R26213,ãûìsï{,ìÏíOés,31629,15392,16237,30964,15033,15931,3252,1707,1545,16680,8536,8144,11139,4828,6311,6160,2390,3770,325,165,523,3,33,12,133,21,75,8
R26214,ãûìsï{,ñÿí√êÏés,77907,37295,40612,76459,36632,39827,12926,6626,6300,44873,21681,23192,19188,8587,10601,8932,3809,5123,561,633,585,1,57,26,127,40,172,16
R26303,ãûìsï{,ëÂéRçËí¨,15953,7710,8243,15781,7623,8158,2327,1170,1157,9183,4578,4605,4351,1908,2443,2373,1002,1371,111,193,130,0,8,6,11,8,15,4
R26322,ãûìsï{,ãvå‰éRí¨,15250,7432,7818,14503,7079,7424,1772,906,866,8361,4227,4134,4875,2164,2711,2382,1035,1347,513,77,159,2,6,6,119,10,65,3
R26343,ãûìsï{,à‰éËí¨,7406,3594,3812,7165,3475,3690,677,367,310,4124,2113,2011,2562,1087,1475,1342,522,820,206,38,96,0,4,1,4,1,2,3
R26344,ãûìsï{,âFé°ìcå¥í¨,8911,4501,4410,8551,4245,4306,1017,531,486,5187,2724,2463,2683,1226,1457,1251,532,719,358,34,101,0,4,3,3,4,9,1
R26364,ãûìsï{,ä}íuí¨,1144,541,603,1120,533,587,48,24,24,470,241,229,582,253,329,329,130,199,3,1,28,0,1,1,1,1,1,1
R26365,ãûìsï{,òaë©í¨,3478,1617,1861,3459,1608,1851,237,117,120,1584,784,800,1655,714,941,828,336,492,16,15,72,0,4,1,3,1,1,1
R26366,ãûìsï{,ê∏âÿí¨,36198,17226,18972,35785,17041,18744,5089,2575,2514,21907,10483,11424,9035,4090,4945,4244,1851,2393,316,219,247,2,29,20,54,30,86,5
R26367,ãûìsï{,ìÏéRèÈë∫,2391,1125,1266,2366,1114,1252,154,85,69,1077,521,556,1158,518,640,608,254,354,20,6,38,0,1,1,1,1,0,1
R26407,ãûìsï{,ãûíOîgí¨,12907,6113,6794,12721,6050,6671,1083,535,548,6045,3067,2978,5705,2466,3239,3139,1202,1937,150,46,214,2,6,6,10,8,9,3
R26463,ãûìsï{,à…ç™í¨,1928,946,982,1920,944,976,178,100,78,814,438,376,934,406,528,523,181,342,8,13,37,0,3,1,0,0,0,2
R26465,ãûìsï{,ó^é”ñÏí¨,20092,9539,10553,19933,9482,10451,2219,1144,1075,10248,5122,5126,7544,3225,4319,4135,1592,2543,97,95,322,1,16,8,83,10,39,6
R27100,ëÂç„ï{,ëÂç„és,2752412,1326875,1425537,2550968,1229030,1321938,290649,148667,141982,1686757,835340,851417,676821,292460,384361,358578,136965,221613,121586,20152,29598,175,3489,2179,9834,3157,11836,527
R27140,ëÂç„ï{,ç‰és,826161,393961,432200,799358,380576,418782,102091,52220,49871,471667,232514,239153,233131,99256,133875,122568,49079,73489,12486,5827,8722,39,742,477,2032,630,1863,129
R27202,ëÂç„ï{,ä›òaìcés,190658,90424,100234,185196,87830,97366,23665,12078,11587,110325,54307,56018,53497,22729,30768,28141,10864,17277,2413,1359,2197,15,136,96,468,135,424,34
R27203,ëÂç„ï{,ñLíÜés,401558,188931,212627,396053,186280,209773,54916,28227,26689,240797,116117,124680,105379,44292,61087,57200,22101,35099,5287,3430,3845,17,415,246,903,359,1356,92
R27204,ëÂç„ï{,írìcés,104993,49992,55001,100902,48020,52882,12844,6485,6359,61529,30451,31078,27786,11770,16016,14995,5962,9033,1882,731,1027,3,102,68,278,105,255,21
R27205,ëÂç„ï{,êÅìcés,385567,185305,200262,370207,177448,192759,51990,26643,25347,231248,113550,117698,88508,37326,51182,45929,18064,27865,4718,3080,3051,14,349,197,2462,707,1415,58
R27206,ëÂç„ï{,êÚëÂí√és,74412,35224,39188,72022,34148,37874,8927,4542,4385,45189,22084,23105,18939,7988,10951,9685,3771,5914,1181,565,726,4,66,46,146,59,133,14
R27207,ëÂç„ï{,çÇíŒés,352698,168081,184617,344704,163931,180773,43042,21967,21075,200510,98166,102344,102233,43811,58422,55470,22905,32565,3022,2406,3330,16,292,184,1581,249,1283,56
R27208,ëÂç„ï{,äLíÀés,84443,40482,43961,83018,39780,43238,10856,5594,5262,49800,24574,25226,23013,9904,13109,12105,4753,7352,865,498,891,4,55,34,181,49,153,20
R27209,ëÂç„ï{,éÁå˚és,143096,69204,73892,138362,66830,71532,15437,7939,7498,83146,41659,41487,40885,17450,23435,22643,8900,13743,2223,1099,1729,6,141,75,565,121,388,26
R27210,ëÂç„ï{,ñáï˚és,397289,188191,209098,377108,178574,198534,45276,22906,22370,212620,102473,110147,110284,47779,62505,56378,23344,33034,3090,2417,3862,23,282,210,1281,363,1014,60
R27211,ëÂç„ï{,àÔñÿés,287730,138658,149072,279012,134101,144911,39221,20116,19105,171964,84334,87630,68701,29902,38799,34967,14370,20597,3216,2282,2398,12,234,149,494,223,853,48
R27212,ëÂç„ï{,î™îˆés,264642,125858,138784,254472,120953,133519,31874,16215,15659,153071,75448,77623,74907,31672,43235,40533,16055,24478,7104,1875,3052,10,212,138,532,206,506,44
R27213,ëÂç„ï{,êÚç≤ñÏés,100131,47828,52303,97349,46457,50892,11488,5936,5552,60883,29962,30921,26232,10997,15235,13811,5227,8584,1735,623,1067,10,89,45,290,64,243,17
R27214,ëÂç„ï{,ïxìcó—és,108699,50919,57780,106571,49841,56730,12109,6164,5945,62665,29924,32741,32782,14286,18496,16739,6798,9941,1311,638,1266,7,87,57,252,90,267,17
R27215,ëÂç„ï{,êQâÆêÏés,229733,110807,118926,222654,107158,115496,25895,13336,12559,129383,64693,64690,68059,29122,38937,35638,14344,21294,2626,1514,2468,13,186,121,393,183,465,45
R27216,ëÂç„ï{,âÕì‡í∑ñÏés,101692,47392,54300,100308,46769,53539,10330,5299,5031,54254,25740,28514,36016,15905,20111,18610,7840,10770,617,459,1241,8,79,57,269,78,259,15
R27217,ëÂç„ï{,èºå¥és,117641,56535,61106,113842,54407,59435,12546,6475,6071,66990,33278,33712,35266,15052,20214,19317,7802,11515,1482,754,1398,5,87,58,221,77,329,19
R27218,ëÂç„ï{,ëÂìåés,119367,57939,61428,113702,55352,58350,13870,7099,6771,70833,35664,35169,31451,13761,17690,15784,6570,9214,2528,775,1190,5,82,53,203,67,223,23
R27219,ëÂç„ï{,òaêÚés,184495,88751,95744,180355,86489,93866,24884,12601,12283,109891,54077,55814,46995,20399,26596,23257,9347,13910,2263,1208,1647,10,128,86,618,118,420,28
R27220,ëÂç„ï{,ñ•ñ és,136868,64992,71876,132176,62950,69226,20385,10401,9984,80023,38902,41121,35261,15161,20100,18572,7662,10910,2373,924,1114,9,118,87,336,115,392,30
R27221,ëÂç„ï{,îêå¥és,68775,32955,35820,66678,31795,34883,7611,3891,3720,40004,19714,20290,19964,8645,11319,10125,4115,6010,1280,396,732,2,47,35,114,46,136,12
R27222,ëÂç„ï{,âHâgñÏés,108736,51034,57702,107037,50242,56795,12338,6214,6124,61958,30154,31804,33318,14141,19177,17723,7022,10701,950,634,1266,6,70,43,259,39,204,16
R27223,ëÂç„ï{,ñÂê^és,119764,58772,60992,115558,56551,59007,11764,6004,5760,70541,36213,34328,35573,15508,20065,19109,7715,11394,2833,691,1435,5,115,72,194,100,323,20
R27224,ëÂç„ï{,ê€í√és,87456,43166,44290,84206,41583,42623,10852,5536,5316,52197,26762,25435,22099,9782,12317,11259,4718,6541,1382,750,768,4,56,40,81,46,203,21
R27225,ëÂç„ï{,çÇêŒés,55635,26336,29299,54653,25861,28792,7006,3563,3443,32402,15892,16510,15666,6608,9058,8227,3186,5041,465,456,668,4,47,39,101,51,117,10
R27226,ëÂç„ï{,ì°à‰éõés,63688,29951,33737,62269,29283,32986,7725,3992,3733,36982,17846,19136,18074,7715,10359,9598,3805,5793,685,409,672,4,72,48,132,60,182,13
R27227,ëÂç„ï{,ìåëÂç„és,493940,240288,253652,434587,213352,221235,52269,26704,25565,283589,142872,140717,135791,58263,77528,72434,28737,43697,13235,3015,5351,19,400,290,952,396,986,81
R27228,ëÂç„ï{,êÚìÏés,60102,28718,31384,58905,28177,30728,7512,3865,3647,34209,16868,17341,17776,7732,10044,9214,3789,5425,589,399,675,6,37,19,78,30,72,7
R27229,ëÂç„ï{,élûäìÎés,55177,26744,28433,54477,26380,28097,6925,3536,3389,32625,16300,16325,15149,6594,8555,7970,3323,4647,481,351,536,3,38,22,82,28,119,10
R27230,ëÂç„ï{,åñÏés,75033,35805,39228,74472,35536,38936,9641,4926,4715,43621,21263,22358,21581,9531,12050,11509,4977,6532,499,489,654,2,52,35,86,47,128,10
R27231,ëÂç„ï{,ëÂç„ã∑éRés,58435,27409,31026,57309,26831,30478,7924,4026,3898,33101,15798,17303,16429,7001,9428,8637,3539,5098,376,426,530,6,51,41,711,76,233,10
R27232,ëÂç„ï{,ç„ìÏés,51254,24250,27004,50808,24026,26782,5615,2873,2742,28470,13780,14690,17072,7555,9517,8481,3562,4919,342,248,588,3,44,28,94,35,83,7
R27301,ëÂç„ï{,ìáñ{í¨,30927,14604,16323,30668,14487,16181,4589,2294,2295,17749,8562,9187,8491,3681,4810,4075,1673,2402,224,259,277,1,25,10,37,14,226,5
R27321,ëÂç„ï{,ñLî\í¨,18279,8676,9603,18183,8634,9549,1201,625,576,8387,4016,4371,8666,4019,4647,4190,1923,2267,93,36,227,0,16,7,13,10,30,2
R27322,ëÂç„ï{,î\ê®í¨,9079,4361,4718,8979,4310,4669,606,295,311,4579,2245,2334,3767,1740,2027,1716,708,1008,95,31,151,0,7,3,4,3,9,2
R27341,ëÂç„ï{,íââ™í¨,16567,7965,8602,16112,7730,8382,1968,1003,965,9791,4968,4823,4778,1977,2801,2607,960,1647,437,102,202,1,14,9,17,11,19,3
R27361,ëÂç„ï{,åFéÊí¨,43763,21310,22453,42825,20811,22014,5665,2955,2710,24799,12298,12501,12444,5562,6882,5871,2573,3298,245,281,414,1,33,17,89,19,94,9
R27362,ëÂç„ï{,ìcêKí¨,8434,4176,4258,8270,4104,4166,1165,608,557,5202,2693,2509,1996,848,1148,1126,445,681,104,75,88,0,7,5,16,4,17,1
R27366,ëÂç„ï{,ñ¶í¨,14741,6816,7925,14478,6738,7740,1173,619,554,7404,3622,3782,5966,2518,3448,3271,1268,2003,91,53,230,1,10,4,17,6,17,3
R27381,ëÂç„ï{,ëæéqí¨,13009,6331,6678,12830,6219,6611,1553,803,750,7476,3731,3745,3844,1708,2136,1935,797,1138,111,62,114,0,8,4,3,4,7,2
R27382,ëÂç„ï{,âÕìÏí¨,15697,7621,8076,15320,7426,7894,1685,905,780,8615,4235,4380,4901,2196,2705,2612,1106,1506,141,80,166,0,9,3,8,3,13,2
R27383,ëÂç„ï{,êÁëÅê‘ç„ë∫,4909,2319,2590,4893,2310,2583,417,215,202,2258,1105,1153,2232,999,1233,1133,498,635,15,19,81,0,5,1,4,1,2,1
R28100,ï∫å…åß,ê_åÀés,1525152,716452,808700,1402061,654287,747774,171315,87893,83422,843645,403562,440083,419161,178066,241095,217966,84147,133819,33009,9765,15870,97,1597,936,5286,1313,5389,270
R28201,ï∫å…åß,ïPòHés,530495,256616,273879,516789,249848,266941,69356,35490,33866,310280,155233,155047,142411,60919,81492,73019,28314,44705,10045,3881,5712,32,410,281,1296,405,1293,103
R28202,ï∫å…åß,ìÚçËés,459593,222293,237300,407327,196102,211225,47978,24690,23288,246316,121181,125135,120113,51240,68873,63387,24984,38403,8420,3677,5166,24,501,245,1373,371,1410,89
R28203,ï∫å…åß,ñæêŒés,303601,146746,156855,295326,142096,153230,41155,21041,20114,177638,88285,89353,79617,34406,45211,40842,16145,24697,3356,2672,2991,19,254,150,792,233,835,62
R28204,ï∫å…åß,êºã{és,485587,226105,259482,472036,220126,251910,64958,33125,31833,293519,138943,154576,115944,48968,66976,59203,23003,36200,6104,3677,4190,23,539,277,1771,372,1516,72
R28205,ï∫å…åß,èFñ{és,41236,19635,21601,40665,19343,21322,4339,2274,2065,21327,10544,10783,15169,6580,8589,7876,3050,4826,284,228,593,2,50,27,199,36,118,12
R28206,ï∫å…åß,à∞âÆés,93922,42008,51914,91172,40724,50448,11455,5816,5639,52989,24085,28904,27654,11339,16315,14644,5533,9111,1441,558,906,3,142,77,200,96,301,19
R28207,ï∫å…åß,à…íOés,198138,95630,102508,195319,94268,101051,27159,13830,13329,119497,59705,59792,51476,22091,29385,27080,10923,16157,2802,1620,1797,10,179,114,490,158,515,38
R28208,ï∫å…åß,ëäê∂és,28355,13592,14763,27903,13348,14555,3238,1660,1578,14479,7356,7123,10414,4440,5974,5608,2174,3434,400,170,388,4,20,15,56,20,53,6
R28209,ï∫å…åß,ñLâ™és,77489,37303,40186,76516,36888,39628,9482,4846,4636,41006,20772,20234,26522,11385,15137,14343,5527,8816,633,508,1149,3,72,29,218,48,174,23
R28210,ï∫å…åß,â¡å√êÏés,260878,127473,133405,255588,124970,130618,32871,16848,16023,151933,76621,75312,72332,32198,40134,35480,14903,20577,2520,1711,2511,12,181,120,618,159,654,47
R28212,ï∫å…åß,ê‘ï‰és,45892,22095,23797,45210,21733,23477,5217,2727,2490,25047,12547,12500,15093,6501,8592,7845,3039,4806,352,222,547,4,39,21,149,36,140,7
R28213,ï∫å…åß,êºòeés,38673,18540,20133,37647,18016,19631,4568,2392,2176,20732,10412,10320,12974,5507,7467,7175,2767,4408,662,203,527,2,38,17,123,25,126,8
R28214,ï∫å…åß,ïÛíÀés,226432,103655,122777,223032,102156,120876,29195,14803,14392,129846,60273,69573,63689,26801,36888,33622,13369,20253,2535,1470,2194,7,215,134,419,181,579,29
R28215,ï∫å…åß,éOñÿés,75294,36259,39035,73407,35241,38166,8230,4198,4032,40261,20050,20211,26408,11759,14649,13703,5834,7869,1650,369,835,5,60,45,142,58,161,16
R28216,ï∫å…åß,çÇçªés,87722,42379,45343,86145,41630,44515,11169,5591,5578,50316,25176,25140,25596,11297,14299,12317,5009,7308,1080,585,972,2,65,40,122,41,189,19
R28217,ï∫å…åß,êÏêºés,152321,71289,81032,151029,70639,80390,18392,9463,8929,84625,40407,44218,49188,21364,27824,27728,11698,16030,1182,877,1726,8,128,75,311,100,422,26
R28218,ï∫å…åß,è¨ñÏés,47562,23232,24330,46502,22670,23832,6325,3333,2992,27104,13641,13463,13844,6107,7737,7012,2849,4163,828,312,480,5,42,24,236,37,139,14
R28219,ï∫å…åß,éOìcés,109238,52322,56916,108024,51728,56296,13945,7207,6738,65910,31508,34402,28853,13321,15532,12713,5106,7607,776,612,901,6,81,50,260,55,353,12
R28220,ï∫å…åß,â¡êºés,42700,21077,21623,41399,20365,21034,4596,2335,2261,23521,12202,11319,14366,6371,7995,7286,2887,4399,1269,207,531,4,29,19,87,26,86,11
R28221,ï∫å…åß,íOîgé¬éRés,39611,18811,20800,38570,18445,20125,4470,2288,2182,20427,10001,10426,13862,6068,7794,7254,2780,4474,762,225,602,4,31,14,80,20,87,8
R28222,ï∫å…åß,ó{ïÉés,22129,10623,11506,22006,10587,11419,2447,1285,1162,10876,5480,5396,8750,3823,4927,4859,1923,2936,106,126,384,1,20,9,67,14,52,11
R28223,ï∫å…åß,íOîgés,61471,29464,32007,60447,28928,31519,7433,3775,3658,32235,16165,16070,21535,9349,12186,11559,4454,7105,928,383,852,2,51,29,134,37,137,13
R28224,ï∫å…åß,ìÏÇ†ÇÌÇ∂és,44137,21114,23023,43424,20832,22592,5190,2635,2555,22362,11152,11210,15956,7000,8956,8335,3299,5036,355,281,676,5,41,25,58,33,87,14
R28225,ï∫å…åß,í©óàés,28989,13893,15096,28614,13773,14841,3394,1738,1656,14817,7457,7360,10351,4431,5920,5661,2111,3550,323,183,463,1,29,14,46,21,59,13
R28226,ï∫å…åß,íWòHés,41967,19872,22095,41488,19649,21839,4495,2242,2253,20946,10380,10566,16265,7103,9162,8924,3441,5483,302,212,706,3,42,21,65,26,79,14
R28227,ï∫å…åß,é≥àæés,34819,16635,18184,34552,16549,18003,4000,2084,1916,18121,9060,9061,12648,5460,7188,6451,2445,4006,236,174,559,1,30,14,56,19,57,16
R28228,ï∫å…åß,â¡ìåés,40645,19956,20689,38177,18759,19418,5119,2569,2550,23844,12124,11720,10757,4785,5972,5523,2216,3307,1726,324,387,2,34,20,64,25,70,14
R28229,ï∫å…åß,ÇΩÇ¬ÇÃés,74316,35918,38398,72643,35063,37580,8995,4669,4326,40382,20156,20226,22963,9937,13026,11365,4452,6913,499,421,932,8,44,28,106,43,144,27
R28301,ï∫å…åß,íññºêÏí¨,29680,13975,15705,29491,13894,15597,3839,1954,1885,16422,7769,8653,9411,4247,5164,4521,1881,2640,189,138,269,2,23,9,45,12,73,4
R28365,ï∫å…åß,ëΩâ¬í¨,19261,9311,9950,18977,9117,9860,1951,1004,947,9809,5001,4808,7306,3204,4102,4081,1632,2449,283,70,290,2,14,8,20,13,27,5
R28381,ï∫å…åß,àÓî¸í¨,30268,14775,15493,29785,14500,15285,3820,2002,1818,16615,8345,8270,9716,4349,5367,4644,2011,2633,405,171,335,1,21,13,41,18,64,4
R28382,ï∫å…åß,îdñÅí¨,33604,16332,17272,32868,15928,16940,4785,2435,2350,19308,9654,9654,9160,4062,5098,4529,1958,2571,466,237,330,1,23,14,34,14,49,4
R28442,ï∫å…åß,ésêÏí¨,11231,5482,5749,11082,5396,5686,1124,572,552,5894,2975,2919,4184,1919,2265,2109,879,1230,129,40,192,0,6,4,7,5,14,3
R28443,ï∫å…åß,ïüçËí¨,19377,9461,9916,18514,9101,9413,2442,1249,1193,10516,5214,5302,5454,2365,3089,2747,1120,1627,445,134,210,0,20,9,35,11,48,6
R28446,ï∫å…åß,ê_âÕí¨,10616,4958,5658,10553,4936,5617,1151,564,587,5399,2638,2761,4055,1747,2308,2207,820,1387,62,59,180,1,9,4,26,5,23,2
R28464,ï∫å…åß,ëæéqí¨,33477,16253,17224,33011,16025,16986,4844,2539,2305,19172,9485,9687,9045,4016,5029,4317,1854,2463,231,227,296,1,22,14,34,20,57,7
R28481,ï∫å…åß,è„åSí¨,13879,6717,7162,13760,6654,7106,1239,669,570,6882,3497,3385,5454,2395,3059,2704,1066,1638,119,41,191,0,10,6,12,8,19,3
R28501,ï∫å…åß,ç≤ópí¨,15863,7567,8296,15712,7497,8215,1462,753,709,7533,3868,3665,6853,2934,3919,3812,1388,2424,143,62,279,3,13,5,22,11,34,5
R28585,ï∫å…åß,çÅî¸í¨,16064,7636,8428,15965,7623,8342,1661,840,821,7870,4035,3835,6530,2759,3771,3732,1379,2353,99,61,285,2,10,7,18,9,16,4
R28586,ï∫å…åß,êVâ∑êÚí¨,13318,6302,7016,13191,6256,6935,1401,714,687,6442,3311,3131,5464,2270,3194,2987,1079,1908,124,60,250,2,14,7,15,7,14,4
R29201,ìﬁó«åß,ìﬁó«és,354630,164846,189784,346733,160779,185954,39706,20229,19477,197673,93359,104314,110212,47204,63008,57745,23238,34507,3047,2057,3651,21,390,185,1059,285,1001,58
R29202,ìﬁó«åß,ëÂòaçÇìcés,61744,28981,32763,60995,28659,32336,5978,3044,2934,35924,17354,18570,19318,8376,10942,9788,3939,5849,532,348,756,3,57,39,161,48,149,12
R29203,ìﬁó«åß,ëÂòaåSéRés,83285,39249,44036,82022,38641,43381,9044,4573,4471,45680,22270,23410,27301,11810,15491,14156,5768,8388,666,462,923,6,81,47,164,53,231,16
R29204,ìﬁó«åß,ìVóùés,63889,31275,32614,62432,30528,31904,7701,3964,3737,38373,19405,18968,16877,7419,9458,8727,3532,5195,740,446,683,5,39,31,366,51,195,10
R29205,ìﬁó«åß,äÄå¥és,120922,57336,63586,118165,55849,62316,14419,7355,7064,69671,33603,36068,34502,15062,19440,17774,7385,10389,904,816,1126,7,115,69,875,127,402,15
R29206,ìﬁó«åß,ç˜à‰és,54857,25909,28948,53981,25516,28465,6330,3211,3119,30665,14902,15763,17491,7629,9862,8969,3578,5391,597,324,631,3,51,28,126,32,137,7
R29207,ìﬁó«åß,å‹ûäés,27927,13180,14747,27640,13071,14569,2049,992,1057,13295,6584,6711,10360,4452,5908,5489,2057,3432,280,85,442,1,32,13,28,16,36,8
R29208,ìﬁó«åß,å‰èäés,24096,11122,12974,23764,11010,12754,1843,935,908,12075,5896,6179,10102,4262,5840,5593,2134,3459,266,96,446,2,28,17,57,22,73,8
R29209,ìﬁó«åß,ê∂ãÓés,116675,55107,61568,114942,54229,60713,16057,8227,7830,66351,31611,34740,33430,14818,18612,16599,7157,9442,1213,683,1080,6,95,60,316,77,297,18
R29210,ìﬁó«åß,çÅé≈és,78113,36925,41188,76817,36372,40445,11918,6017,5901,46856,22398,24458,18430,8119,10311,9231,3935,5296,508,667,585,3,58,40,111,55,134,16
R29211,ìﬁó«åß,äãèÈés,36832,17526,19306,36460,17306,19154,5610,2898,2712,20796,10019,10777,10338,4556,5782,5134,2145,2989,349,271,383,1,24,16,30,23,77,6
R29212,ìﬁó«åß,âFë…és,28121,13374,14747,27833,13257,14576,2481,1288,1193,13770,6814,6956,11793,5234,6559,6000,2409,3591,238,97,456,2,22,11,45,15,36,5
R29322,ìﬁó«åß,éRìYë∫,3226,1543,1683,3185,1524,1661,255,132,123,1401,721,680,1557,685,872,784,299,485,34,10,65,0,5,1,3,2,0,0
R29342,ìﬁó«åß,ïΩåQí¨,18009,8446,9563,17882,8385,9497,1815,938,877,9177,4386,4791,6968,3096,3872,3738,1626,2112,99,73,236,0,12,10,9,14,38,2
R29343,ìﬁó«åß,éOãΩí¨,23219,10877,12342,23002,10781,12221,2785,1427,1358,12779,6207,6572,7530,3172,4358,4053,1641,2412,148,162,243,2,14,6,118,8,70,4
R29344,ìﬁó«åß,î¡îµí¨,27587,12979,14608,27322,12855,14467,3831,1949,1882,15222,7301,7921,8393,3671,4722,4408,1877,2531,181,209,293,0,22,10,19,17,45,3
R29345,ìﬁó«åß,à¿ìgí¨,7225,3387,3838,7005,3300,3705,650,322,328,3966,1940,2026,2544,1088,1456,1259,475,784,203,35,99,0,2,2,2,2,2,1
R29361,ìﬁó«åß,êÏêºí¨,8167,3944,4223,7998,3838,4160,978,509,469,4360,2145,2215,2809,1274,1535,1435,644,791,157,39,92,0,6,4,4,6,4,2
R29362,ìﬁó«åß,éOëÓí¨,6439,3049,3390,6354,3010,3344,632,311,321,3475,1702,1773,2330,1035,1295,1242,535,707,83,35,92,0,1,0,1,0,2,1
R29363,ìﬁó«åß,ìcå¥ñ{í¨,31177,14870,16307,30885,14730,16155,3677,1891,1786,17273,8422,8851,9959,4395,5564,5145,2125,3020,208,212,346,2,27,14,63,12,53,4
R29385,ìﬁó«åß,ë]é¢ë∫,1295,595,700,1280,586,694,85,40,45,542,269,273,668,286,382,368,140,228,15,3,26,0,1,0,1,1,1,0
R29386,ìﬁó«åß,å‰èÒë∫,1479,694,785,1470,688,782,50,24,26,534,291,243,891,377,514,557,210,347,9,4,41,0,3,1,1,1,1,0
R29401,ìﬁó«åß,çÇéÊí¨,6729,3139,3590,6699,3133,3566,610,301,309,3304,1636,1668,2782,1189,1593,1544,582,962,9,14,103,0,9,4,15,5,39,1
R29402,ìﬁó«åß,ñæì˙çÅë∫,5179,2439,2740,5154,2427,2727,526,268,258,2517,1243,1274,2131,926,1205,1103,420,683,15,19,81,0,6,2,2,2,12,1
R29424,ìﬁó«åß,è„ñqí¨,21714,10117,11597,21577,10053,11524,2105,1069,1036,11826,5753,6073,7783,3295,4488,4133,1634,2499,137,80,318,3,11,8,44,13,51,4
R29425,ìﬁó«åß,â§éõí¨,24043,11375,12668,23647,11161,12486,3507,1839,1668,13527,6369,7158,6735,3002,3733,3357,1441,1916,195,202,245,1,28,16,39,22,65,2
R29426,ìﬁó«åß,çLóÀí¨,33810,16045,17765,33517,15897,17620,4980,2503,2477,19828,9473,10355,8849,4010,4839,4099,1731,2368,178,201,302,0,22,15,20,15,29,7
R29427,ìﬁó«åß,âÕçáí¨,17018,7918,9100,16887,7849,9038,1714,903,811,8648,4134,4514,6574,2826,3748,3533,1499,2034,111,65,192,0,17,10,16,12,39,2
R29441,ìﬁó«åß,ãgñÏí¨,6229,2840,3389,6164,2797,3367,373,194,179,2620,1251,1369,3236,1395,1841,1783,691,1092,65,12,145,1,6,6,13,7,9,1
R29442,ìﬁó«åß,ëÂóÑí¨,16728,7936,8792,16479,7827,8652,1641,854,787,9261,4580,4681,5784,2492,3292,2846,1087,1759,207,55,254,2,11,6,82,9,51,5
R29443,ìﬁó«åß,â∫ésí¨,5037,2356,2681,5000,2342,2658,325,182,143,2353,1155,1198,2359,1019,1340,1373,524,849,37,12,117,0,3,3,6,3,4,1
R29444,ìﬁó«åß,çïëÍë∫,623,296,327,617,292,325,43,23,20,236,122,114,344,151,193,189,76,113,6,8,20,0,1,1,1,0,0,0
R29446,ìﬁó«åß,ìVêÏë∫,1176,567,609,1175,566,609,96,56,40,482,257,225,598,254,344,329,123,206,1,3,21,0,1,1,1,1,4,0
R29447,ìﬁó«åß,ñÏîóêÏë∫,357,176,181,351,171,180,12,9,3,164,95,69,180,72,108,117,40,77,6,0,4,0,1,0,1,0,0,0
R29449,ìﬁó«åß,è\í√êÏë∫,3061,1663,1398,3043,1651,1392,230,118,112,1526,967,559,1305,578,727,775,296,479,18,10,62,0,5,1,5,1,0,0
R29450,ìﬁó«åß,â∫ñkéRë∫,753,361,392,746,356,390,53,30,23,334,178,156,366,153,213,217,75,142,7,5,22,0,1,1,1,0,0,0
R29451,ìﬁó«åß,è„ñkéRë∫,444,227,217,443,226,217,15,10,5,199,112,87,230,105,125,146,59,87,1,3,14,0,1,0,1,0,0,0
R29452,ìﬁó«åß,êÏè„ë∫,1156,554,602,1143,544,599,69,33,36,444,243,201,642,277,365,408,152,256,13,6,41,0,1,1,1,0,0,0
R29453,ìﬁó«åß,ìåãgñÏë∫,1502,703,799,1480,702,778,78,47,31,548,274,274,875,381,494,513,201,312,22,2,42,0,5,0,3,0,0,0
R30201,òaâÃéRåß,òaâÃéRés,356729,167947,188782,352193,166025,186168,42340,21601,20739,201722,98698,103024,109950,45956,63994,58777,22470,36307,3045,2523,4328,34,424,226,1656,327,1238,61
R30202,òaâÃéRåß,äCìÏés,48369,22548,25821,47835,22335,25500,4867,2466,2401,25370,12413,12957,17720,7468,10252,9694,3716,5978,256,239,743,5,52,30,104,41,129,6
R30203,òaâÃéRåß,ã¥ñ{és,60818,28621,32197,60238,28359,31879,6957,3543,3414,33405,16002,17403,20116,8865,11251,10077,4024,6053,313,344,728,3,64,33,141,43,140,15
R30204,òaâÃéRåß,óLìcés,26538,12576,13962,26242,12441,13801,2769,1436,1333,14289,7104,7185,9270,3925,5345,4831,1811,3020,137,127,354,2,29,15,50,19,62,7
R30205,òaâÃéRåß,å‰ñVés,23481,11404,12077,22999,11178,11821,2496,1282,1214,13155,6755,6400,7333,3077,4256,3834,1439,2395,163,131,331,3,34,17,119,25,105,6
R30206,òaâÃéRåß,ìcï”és,69870,32790,37080,68975,32434,36541,7944,3965,3979,37608,18503,19105,23429,9884,13545,12846,4883,7963,252,432,1044,4,80,40,240,57,134,19
R30207,òaâÃéRåß,êVã{és,27171,12610,14561,26508,12275,14233,2869,1494,1375,13339,6465,6874,10111,4133,5978,5576,2046,3530,163,141,422,2,36,27,87,36,54,10
R30208,òaâÃéRåß,ãIÇÃêÏés,58816,27815,31001,58120,27475,30645,6553,3293,3260,32440,15918,16522,19449,8427,11022,9849,3806,6043,397,290,782,4,61,27,133,35,129,13
R30209,òaâÃéRåß,ä‚èoés,53967,25969,27998,52937,25413,27524,7295,3831,3464,32952,15977,16975,12849,5651,7198,5979,2419,3560,383,411,423,3,45,21,84,31,88,8
R30304,òaâÃéRåß,ãIî¸ñÏí¨,8256,3796,4460,8221,3780,4441,585,299,286,3662,1848,1814,4009,1649,2360,2290,835,1455,35,19,166,1,11,3,24,3,18,2
R30341,òaâÃéRåß,Ç©Ç¬ÇÁÇ¨í¨,15967,7428,8539,15864,7381,8483,1643,829,814,7867,3934,3933,6425,2644,3781,3589,1304,2285,77,83,251,1,18,10,33,13,40,2
R30343,òaâÃéRåß,ã„ìxéRí¨,3856,1782,2074,3850,1780,2070,286,149,137,1773,855,918,1792,774,1018,1032,402,630,4,14,72,0,4,0,10,0,8,1
R30344,òaâÃéRåß,çÇñÏí¨,2970,1499,1471,2936,1481,1455,227,127,100,1502,863,639,1220,493,727,714,257,457,29,16,65,0,5,2,5,3,10,1
R30361,òaâÃéRåß,ìíêÛí¨,11122,5196,5926,11018,5142,5876,1185,615,570,5766,2830,2936,4089,1703,2386,2095,776,1319,37,59,180,1,13,6,33,8,24,4
R30362,òaâÃéRåß,çLêÏí¨,6781,3195,3586,6717,3150,3567,818,425,393,3521,1724,1797,2413,1025,1388,1206,455,751,44,31,94,0,4,2,3,4,6,2
R30366,òaâÃéRåß,óLìcêÏí¨,25258,11953,13305,25167,11910,13257,3273,1665,1608,13621,6713,6908,8325,3547,4778,4693,1773,2920,76,214,407,2,27,14,49,16,55,7
R30381,òaâÃéRåß,î¸ïlí¨,6867,3217,3650,6831,3205,3626,690,343,347,3590,1800,1790,2566,1059,1507,1391,523,868,29,25,144,1,8,1,21,1,22,2
R30382,òaâÃéRåß,ì˙çÇí¨,7673,3657,4016,7644,3646,3998,1197,641,556,4135,2019,2116,2317,983,1334,1244,449,795,17,69,88,0,4,3,4,3,9,2
R30383,òaâÃéRåß,óRó«í¨,5364,2685,2679,5314,2647,2667,500,265,235,2724,1474,1250,2088,901,1187,1074,394,680,37,23,108,0,5,3,2,3,0,1
R30390,òaâÃéRåß,àÛìÏí¨,7720,3660,4060,7684,3640,4044,942,477,465,3910,1922,1988,2855,1248,1607,1468,572,896,32,46,127,0,5,2,5,2,7,1
R30391,òaâÃéRåß,Ç›Ç»Ç◊í¨,11818,5608,6210,11710,5568,6142,1427,728,699,6413,3154,3259,3929,1694,2235,2055,805,1250,77,67,191,0,10,4,8,5,13,4
R30392,òaâÃéRåß,ì˙çÇêÏí¨,9219,4449,4770,9185,4427,4758,1093,565,528,4737,2475,2262,3388,1409,1979,1877,681,1196,33,55,152,0,10,2,7,2,5,3
R30401,òaâÃéRåß,îíïlí¨,20262,9440,10822,19989,9314,10675,1940,973,967,10121,5031,5090,8017,3321,4696,4497,1697,2800,145,88,389,2,18,7,40,8,25,6
R30404,òaâÃéRåß,è„ïxìcí¨,15236,7246,7990,15095,7184,7911,2148,1123,1025,8838,4302,4536,4112,1756,2356,1988,761,1227,38,124,170,1,12,7,16,10,25,2
R30406,òaâÃéRåß,Ç∑Ç≥Ç›í¨,3685,1747,1938,3649,1723,1926,301,167,134,1568,830,738,1795,737,1058,1100,391,709,22,22,93,1,7,2,8,3,2,1
R30421,òaâÃéRåß,ìﬂíqèüâYí¨,14137,6531,7606,14016,6491,7525,1351,698,653,6556,3251,3305,6200,2561,3639,3455,1261,2194,107,56,291,2,11,13,24,16,20,7
R30422,òaâÃéRåß,ëæíní¨,2791,1229,1562,2779,1226,1553,202,101,101,1335,624,711,1251,503,748,727,252,475,10,6,83,0,3,2,1,2,2,1
R30424,òaâÃéRåß,å√ç¿êÏí¨,2480,1130,1350,2468,1129,1339,184,106,78,926,482,444,1370,542,828,852,299,553,12,8,71,0,6,1,4,1,1,1
R30427,òaâÃéRåß,ñkéRë∫,404,183,221,404,183,221,40,14,26,182,103,79,182,66,116,128,35,93,0,4,9,0,1,0,1,0,0,0
R30428,òaâÃéRåß,ã¯ñ{í¨,14959,7140,7819,14820,7074,7746,1238,663,575,6677,3446,3231,6930,2953,3977,3738,1423,2315,59,65,304,3,15,6,29,10,29,2
R31201,íπéÊåß,íπéÊés,188465,91356,97109,185241,89741,95500,23684,12179,11505,106218,53662,52556,54990,23291,31699,27845,10090,17755,1306,1358,2135,10,159,96,568,137,444,50
R31202,íπéÊåß,ïƒéqés,147317,69740,77577,143338,68075,75263,19171,9758,9413,82094,40531,41563,42337,17630,24707,22167,8268,13899,1170,1150,1736,11,166,75,878,119,434,46
R31203,íπéÊåß,ëqãgés,46485,21840,24645,45956,21593,24363,5723,3007,2716,24287,11922,12365,16034,6641,9393,8530,3048,5482,303,314,646,8,51,27,190,36,159,26
R31204,íπéÊåß,ã´ç`és,32740,15775,16965,32151,15594,16557,3912,2031,1881,17948,9161,8787,10736,4504,6232,5669,2087,3582,482,187,428,2,27,12,70,22,46,11
R31302,íπéÊåß,ä‚î¸í¨,10799,5178,5621,10718,5138,5580,1143,610,533,5598,2845,2753,4053,1721,2332,2098,764,1334,76,61,197,1,5,3,13,4,6,3
R31325,íπéÊåß,é·ç˜í¨,2864,1355,1509,2834,1351,1483,191,107,84,1279,659,620,1393,588,805,831,303,528,30,6,66,0,3,2,4,3,4,1
R31328,íπéÊåß,íqì™í¨,6427,3005,3422,6359,2989,3370,621,318,303,3005,1519,1486,2801,1168,1633,1584,539,1045,68,30,121,1,4,2,10,4,8,1
R31329,íπéÊåß,î™ì™í¨,15937,7611,8326,15868,7603,8265,1853,949,904,8289,4135,4154,5792,2525,3267,2949,1072,1877,69,106,219,0,13,7,13,11,13,5
R31364,íπéÊåß,éOí©í¨,6060,2875,3185,5995,2849,3146,676,352,324,2962,1502,1460,2408,1015,1393,1307,468,839,61,21,90,1,3,2,13,2,7,3
R31370,íπéÊåß,ìíóúïlí¨,16055,7657,8398,15955,7636,8319,2264,1158,1106,8602,4253,4349,5139,2220,2919,2578,936,1642,91,120,197,0,9,5,10,4,19,9
R31371,íπéÊåß,ã’âYí¨,16365,7682,8683,16166,7630,8536,1979,976,1003,8356,4147,4209,6028,2558,3470,3321,1230,2091,199,92,251,0,14,6,16,7,15,7
R31372,íπéÊåß,ñkâhí¨,14228,6818,7410,14121,6792,7329,1793,950,843,7352,3691,3661,5060,2161,2899,2504,943,1561,104,87,206,0,4,3,6,4,3,6
R31384,íπéÊåß,ì˙ãgí√ë∫,3501,1628,1873,3448,1612,1836,507,246,261,1979,974,1005,986,397,589,497,180,317,32,31,35,0,4,1,7,1,15,1
R31386,íπéÊåß,ëÂéRí¨,15370,7390,7980,15251,7343,7908,1684,868,816,7491,3852,3639,6195,2670,3525,3295,1236,2059,119,70,284,0,11,5,12,7,10,5
R31389,íπéÊåß,ìÏïîí¨,10323,4925,5398,10228,4883,5345,1179,588,591,5261,2657,2604,3879,1677,2202,1976,766,1210,92,48,123,1,5,1,22,2,14,4
R31390,íπéÊåß,îå„Àí¨,10696,5051,5645,10636,5032,5604,1282,633,649,5148,2578,2570,4243,1831,2412,2260,840,1420,47,67,141,2,6,3,18,4,18,5
R31401,íπéÊåß,ì˙ìÏí¨,4196,1982,2214,4168,1964,2204,296,153,143,1708,940,768,2190,887,1303,1380,480,900,28,15,108,1,1,1,7,0,6,1
R31402,íπéÊåß,ì˙ñÏí¨,2907,1323,1584,2884,1322,1562,183,84,99,1253,650,603,1471,589,882,868,299,569,23,9,53,1,2,2,10,1,7,1
R31403,íπéÊåß,ç]ï{í¨,2672,1241,1431,2662,1240,1422,189,93,96,1172,605,567,1311,543,768,816,301,515,10,11,60,0,3,0,4,1,1,1
R32201,ìáç™åß,èºç]és,203616,98544,105072,198573,95843,102730,25931,13359,12572,113547,57385,56162,59498,25123,34375,31598,11673,19925,1336,1492,2343,8,217,77,621,136,467,78
R32202,ìáç™åß,ïlìcés,54592,27298,27294,53624,26919,26705,5940,3024,2916,28524,15611,12913,19445,8160,11285,10545,3822,6723,651,305,837,3,62,23,163,31,121,27
R32203,ìáç™åß,èoâ_és,172775,83469,89306,166846,80284,86562,23315,11956,11359,95332,47887,47445,51944,22402,29542,27198,10293,16905,4158,1328,2077,9,168,62,847,110,430,57
R32204,ìáç™åß,âvìcés,45003,21355,23648,44089,20959,23130,5284,2751,2533,21988,11045,10943,17017,7181,9836,8997,3290,5707,347,291,744,2,54,26,118,32,117,29
R32205,ìáç™åß,ëÂìcés,32846,15742,17104,32347,15516,16831,3655,1944,1711,15778,8042,7736,13264,5677,7587,7284,2650,4634,338,191,594,1,39,13,75,17,62,20
R32206,ìáç™åß,à¿óàés,37062,17743,19319,36697,17609,19088,4277,2204,2073,18817,9609,9208,13835,5866,7969,7521,2806,4715,262,214,623,2,31,9,70,12,52,19
R32207,ìáç™åß,ç]í√és,22959,10890,12069,22650,10779,11871,2403,1199,1204,11467,5879,5588,9008,3744,5264,4901,1695,3206,282,111,422,3,27,7,42,13,42,11
R32209,ìáç™åß,â_ìÏés,36007,17316,18691,35771,17249,18522,4041,2082,1959,17487,8875,8612,14422,6325,8097,7878,2985,4893,212,207,618,2,29,14,58,20,48,13
R32343,ìáç™åß,âúèoâ_í¨,11849,5705,6144,11759,5684,6075,1160,593,567,5341,2806,2535,5130,2230,2900,2888,1075,1813,89,50,233,1,10,4,16,6,13,6
R32386,ìáç™åß,î—ìÏí¨,4577,2157,2420,4535,2147,2388,463,245,218,1998,1030,968,2114,880,1234,1254,444,810,42,26,99,1,6,1,7,3,5,4
R32441,ìáç™åß,êÏñ{í¨,3248,1556,1692,3229,1552,1677,320,160,160,1477,784,693,1433,605,828,836,300,536,19,17,76,1,2,2,10,6,6,3
R32448,ìáç™åß,î¸ãΩí¨,4355,2080,2275,4337,2074,2263,498,261,237,1772,937,835,2084,881,1203,1203,439,764,18,23,91,0,8,1,3,1,4,2
R32449,ìáç™åß,óWìÏí¨,10163,4874,5289,10063,4821,5242,1084,548,536,4478,2349,2129,4582,1967,2615,2666,1000,1666,84,51,223,1,18,3,23,4,14,9
R32501,ìáç™åß,í√òañÏí¨,6875,3221,3654,6823,3216,3607,593,310,283,2944,1528,1416,3337,1382,1955,1932,693,1239,52,20,140,1,8,3,10,4,10,3
R32505,ìáç™åß,ãgâÍí¨,6077,2944,3133,5855,2816,3039,573,282,291,2745,1494,1251,2720,1129,1591,1571,558,1013,221,37,127,1,6,2,11,3,14,4
R32525,ìáç™åß,äCémí¨,2267,1113,1154,2255,1107,1148,244,123,121,1118,581,537,905,409,496,493,194,299,12,15,40,0,2,2,2,2,0,1
R32526,ìáç™åß,êºÉmìáí¨,2788,1430,1358,2757,1407,1350,253,142,111,1246,706,540,1289,582,707,668,260,408,31,14,49,1,4,1,6,2,3,2
R32527,ìáç™åß,ímïvë∫,634,323,311,631,321,310,69,28,41,281,158,123,284,137,147,151,67,84,3,5,9,0,1,1,1,2,0,1
R32528,ìáç™åß,âBäÚÇÃìáí¨,13433,6531,6902,13356,6508,6848,1538,791,747,6316,3352,2964,5570,2381,3189,2906,1038,1868,73,76,240,1,13,6,25,5,21,8
R33100,â™éRåß,â™éRés,724691,348630,376061,694651,333235,361416,92756,47526,45230,424785,210504,214281,185732,79007,106725,97154,37252,59902,11844,5627,6786,50,694,443,3259,970,2187,144
R33202,â™éRåß,ëqï~és,474592,228261,246331,440084,213135,226949,58486,29868,28618,249921,122761,127160,125532,54731,70801,65415,26501,38914,4361,3846,4807,32,348,225,1882,365,970,98
R33203,â™éRåß,í√éRés,99937,48012,51925,97681,46907,50774,12449,6450,5999,55234,27746,27488,30544,12829,17715,16054,5946,10108,832,736,1212,8,96,46,276,64,230,28
R33204,â™éRåß,ã ñÏés,56531,27437,29094,55556,26991,28565,5608,2950,2658,28734,14685,14049,21774,9570,12204,11632,4706,6926,615,260,819,7,51,36,86,49,100,12
R33205,â™éRåß,ä}â™és,46088,21866,24222,45238,21511,23727,4419,2247,2172,23004,11443,11561,17064,7285,9779,9547,3626,5921,490,232,746,3,40,27,93,36,85,13
R33207,â™éRåß,à‰å¥és,38384,18353,20031,37788,18151,19637,3880,1977,1903,20028,10142,9886,14355,6156,8199,8072,3079,4993,512,191,598,3,29,21,51,26,64,9
R33208,â™éRåß,ëçé–és,69030,33425,35605,66634,32346,34288,9589,4986,4603,39165,19494,19671,19408,8508,10900,9800,3933,5867,1593,526,710,3,48,27,78,49,80,15
R33209,â™éRåß,çÇó¿és,29072,14225,14847,28056,13597,14459,2546,1291,1255,14264,7622,6642,11904,5065,6839,6889,2507,4382,900,111,540,3,32,14,67,23,54,7
R33210,â™éRåß,êVå©és,28079,13411,14668,27757,13296,14461,2676,1426,1250,13644,6927,6717,11606,4960,6646,6728,2522,4206,271,118,544,4,29,11,34,12,45,12
R33211,â™éRåß,îıëOés,32320,15516,16804,31623,15054,16569,2961,1538,1423,16406,8415,7991,12732,5397,7335,7117,2730,4387,548,147,553,4,34,17,51,19,44,10
R33212,â™éRåß,ê£åÀì‡és,36048,17319,18729,35407,17048,18359,4071,2185,1886,19264,9640,9624,12422,5347,7075,6681,2620,4061,420,181,555,4,29,13,63,31,54,9
R33213,â™éRåß,ê‘î÷és,42661,20454,22207,42018,20107,21911,5745,2985,2760,22267,10898,11369,14377,6402,7975,7208,3021,4187,483,284,485,1,36,25,50,33,66,16
R33214,â™éRåß,ê^íÎés,42725,20397,22328,42384,20254,22130,4863,2507,2356,20687,10589,10098,17061,7230,9831,9445,3458,5987,291,242,776,6,43,19,79,21,69,18
R33215,â™éRåß,î¸çÏés,25939,12452,13487,25456,12146,13310,2612,1349,1263,12356,6355,6001,10800,4642,6158,6017,2230,3787,380,117,507,3,24,10,32,15,32,7
R33216,â™éRåß,êÛå˚és,32772,15760,17012,32437,15648,16789,3589,1854,1735,17005,8550,8455,12047,5290,6757,6616,2725,3891,225,193,469,2,18,13,36,17,42,9
R33346,â™éRåß,òaãCí¨,13623,6468,7155,13351,6330,7021,1266,649,617,6727,3446,3281,5598,2358,3240,3131,1175,1956,248,50,230,2,12,5,19,9,26,3
R33423,â™éRåß,ëÅìáí¨,12368,5930,6438,12285,5894,6391,2027,1058,969,6881,3336,3545,3433,1518,1915,1773,745,1028,67,143,113,1,9,6,41,13,31,3
R33445,â™éRåß,ó¢èØí¨,10950,5206,5744,10795,5156,5639,1525,809,716,5965,2901,3064,3454,1491,1963,1892,758,1134,155,69,107,1,5,4,9,6,18,2
R33461,â™éRåß,ñÓä|í¨,13414,6412,7002,13039,6230,6809,1423,706,717,6726,3418,3308,5207,2263,2944,2882,1150,1732,368,74,217,2,8,7,21,9,23,4
R33586,â™éRåß,êVèØë∫,813,380,433,802,370,432,99,45,54,368,187,181,346,148,198,212,83,129,11,7,14,0,1,1,0,1,0,1
R33606,â™éRåß,ãæñÏí¨,12062,5810,6252,11950,5769,6181,1485,814,671,5873,2949,2924,4674,2029,2645,2526,952,1574,84,94,200,2,11,7,19,6,9,6
R33622,â™éRåß,èüâõí¨,10888,5204,5684,10835,5184,5651,1580,817,763,5821,2877,2944,3465,1499,1966,1849,688,1161,46,94,137,1,6,4,10,9,27,5
R33623,â™éRåß,ìﬁã`í¨,5578,2788,2790,5552,2774,2778,736,372,364,2864,1572,1292,1977,844,1133,1052,394,658,26,50,88,0,4,2,7,4,4,1
R33643,â™éRåß,êºàæëqë∫,1398,651,747,1392,647,745,178,86,92,725,360,365,495,205,290,251,83,168,6,5,24,0,1,2,0,2,0,1
R33663,â™éRåß,ãvïƒìÏí¨,4530,2173,2357,4493,2162,2331,398,194,204,2098,1068,1030,2034,911,1123,1156,478,678,37,21,79,0,5,2,2,2,3,3
R33666,â™éRåß,î¸çÁí¨,13053,6230,6823,12978,6218,6760,1423,726,697,6205,3194,3011,5421,2306,3115,2998,1091,1907,75,64,265,1,11,5,6,10,3,4
R33681,â™éRåß,ãgîıíÜâõí¨,10886,5275,5611,10658,5209,5449,962,509,453,5377,2828,2549,4529,1923,2606,2562,924,1638,228,39,207,2,13,4,19,6,15,7
R34100,çLìáåß,çLìáés,1200754,579415,621339,1159414,559326,600088,158290,80812,77478,706497,349371,357126,300882,130009,170873,151253,59360,91893,17500,9179,10296,75,1198,687,3935,1363,3481,230
R34202,çLìáåß,å‡és,214592,103816,110776,210692,101713,108979,23037,11704,11333,114245,59028,55217,75706,32156,43550,41692,16083,25609,3022,1198,3154,21,218,142,729,223,586,59
R34203,çLìáåß,í|å¥és,23993,11434,12559,23661,11266,12395,2126,1074,1052,11643,5953,5690,10082,4316,5766,5597,2125,3472,228,101,408,3,23,12,49,13,55,9
R34204,çLìáåß,éOå¥és,90573,43155,47418,88139,41925,46214,10438,5431,5007,47477,23755,23722,32182,13705,18477,17130,6496,10634,2130,453,1293,9,68,49,204,67,207,22
R34205,çLìáåß,îˆìπés,131170,63468,67702,127797,61021,66776,14313,7337,6976,68334,35201,33133,47641,20352,27289,25780,9858,15922,2718,704,1923,10,124,68,364,98,387,31
R34207,çLìáåß,ïüéRés,460930,224246,236684,446471,216471,230000,60655,31047,29608,260383,131056,129327,132167,57503,74664,67599,26647,40952,8231,3553,4956,36,341,228,1037,342,1200,116
R34208,çLìáåß,ï{íÜés,37655,18115,19540,37039,17797,19242,3922,2039,1883,19284,9941,9343,14371,6097,8274,7903,3071,4832,562,163,555,3,32,20,60,28,82,11
R34209,çLìáåß,éOéüés,50681,24220,26461,49622,23670,25952,5947,3045,2902,25685,13083,12602,18437,7715,10722,10246,3668,6578,628,319,871,4,52,24,147,35,113,23
R34210,çLìáåß,èØå¥és,33633,16014,17619,33126,15782,17344,3438,1744,1694,15411,8010,7401,14579,6138,8441,8445,3059,5386,400,178,630,5,36,18,80,26,64,17
R34211,çLìáåß,ëÂí|és,26319,12820,13499,25944,12609,13335,2859,1474,1385,13975,7270,6705,9406,4021,5385,5128,1976,3152,320,167,343,3,26,14,95,24,77,7
R34212,çLìáåß,ìåçLìáés,196608,99690,96918,185140,94175,90965,26734,13759,12975,118251,62572,55679,45736,20250,25486,22700,9149,13551,6626,1424,1587,14,134,84,409,116,364,59
R34213,çLìáåß,ì˘ì˙ésés,114173,54393,59780,112237,53425,58812,14927,7712,7215,63443,30726,32717,34962,15448,19514,17121,6896,10225,1244,751,1212,9,98,60,311,96,254,33
R34214,çLìáåß,à¿å|çÇìcés,26448,12614,13834,25724,12285,13439,2621,1333,1288,12684,6532,6152,11112,4723,6389,6200,2267,3933,696,112,473,1,29,17,58,21,85,12
R34215,çLìáåß,ç]ìcìáés,21930,11025,10905,21315,10632,10683,1657,871,786,10656,6062,4594,9572,4058,5514,5355,2033,3322,584,75,452,3,18,11,38,17,33,5
R34302,çLìáåß,ï{íÜí¨,51155,25007,26148,50362,24638,25724,7520,3867,3653,30651,15393,15258,12570,5557,7013,6440,2632,3808,615,499,417,1,40,28,114,44,159,6
R34304,çLìáåß,äCìcí¨,29636,14588,15048,28701,14140,14561,4391,2227,2164,18016,9203,8813,7061,3069,3992,3498,1398,2100,831,300,222,2,31,19,37,39,64,8
R34307,çLìáåß,åFñÏí¨,22834,10958,11876,22601,10841,11760,2886,1484,1402,11778,5834,5944,8136,3616,4520,4330,1864,2466,200,126,263,0,14,12,16,17,21,4
R34309,çLìáåß,ç‚í¨,12582,5984,6598,12385,5857,6528,1826,910,916,7021,3468,3553,3716,1593,2123,1955,748,1207,182,97,161,1,10,3,38,5,19,4
R34368,çLìáåß,à¿å|ëæìcí¨,5740,2675,3065,5698,2666,3032,466,221,245,2283,1202,1081,2991,1252,1739,1813,662,1151,42,16,135,1,6,5,14,6,15,4
R34369,çLìáåß,ñkçLìáí¨,17763,8768,8995,17065,8346,8719,1805,899,906,8732,4768,3964,6917,2911,4006,3921,1410,2511,485,74,300,3,14,11,31,14,27,13
R34431,çLìáåß,ëÂçËè„ìáí¨,7158,3663,3495,7012,3564,3448,553,273,280,3228,1979,1249,3305,1350,1955,1978,719,1259,146,25,146,0,9,5,6,7,8,1
R34462,çLìáåß,ê¢óÖí¨,15125,7156,7969,14859,7065,7794,1560,769,791,6893,3495,3398,6342,2713,3629,3530,1314,2216,255,59,271,1,8,5,24,6,24,6
R34545,çLìáåß,ê_êŒçÇå¥í¨,8250,3932,4318,8159,3909,4250,707,373,334,3484,1805,1679,4058,1753,2305,2414,912,1502,88,33,176,1,4,5,9,5,7,5
R35201,éRå˚åß,â∫ä÷és,255051,118683,136368,249196,115771,133425,28155,14387,13768,133298,65281,68017,90326,36995,53331,47776,17384,30392,3872,1427,3639,21,268,138,703,226,625,53
R35202,éRå˚åß,âFïîés,162570,77793,84777,159420,76240,83180,18676,9644,9032,87786,44239,43547,54008,22734,31274,27773,10364,17409,1682,1081,2089,14,155,82,860,143,507,28
R35203,éRå˚åß,éRå˚és,193966,92352,101614,189145,89856,99289,24166,12354,11812,109862,54160,55702,56173,23682,32491,29218,10786,18432,1547,1314,2213,13,168,91,461,129,537,37
R35204,éRå˚åß,îãés,44626,20610,24016,44203,20464,23739,3910,1987,1923,20919,10405,10514,19613,8095,11518,10436,3757,6679,380,189,824,6,48,24,92,35,96,18
R35206,éRå˚åß,ñhï{és,113979,54951,59028,111943,54098,57845,14658,7565,7093,63274,32104,31170,35036,14808,20228,18227,6891,11336,1175,848,1401,8,86,54,297,80,242,22
R35207,éRå˚åß,â∫èºés,55887,27405,28482,55204,26958,28246,7779,3957,3822,31231,16083,15148,16521,7066,9455,8591,3367,5224,561,495,632,3,48,23,84,39,114,10
R35208,éRå˚åß,ä‚çëés,129125,60981,68144,126304,59769,66535,14495,7374,7121,67305,33430,33875,46114,19605,26509,25073,9423,15650,1769,777,1906,15,124,59,307,84,326,30
R35210,éRå˚åß,åıés,49798,23711,26087,49062,23332,25730,5702,2945,2757,25763,12949,12814,17834,7577,10257,9820,3947,5873,436,316,688,5,38,20,90,29,168,12
R35211,éRå˚åß,í∑ñÂés,32519,15040,17479,32030,14847,17183,3039,1573,1466,15077,7462,7615,14318,5939,8379,7554,2720,4834,457,141,584,3,26,15,57,18,75,7
R35212,éRå˚åß,ñˆà‰és,30799,14345,16454,30424,14198,16226,3241,1674,1567,15268,7569,7699,12004,4964,7040,6484,2340,4144,164,149,521,3,37,18,101,26,97,11
R35213,éRå˚åß,î¸îIés,23247,10857,12390,23011,10712,12299,1963,1025,938,11302,5646,5656,9898,4126,5772,5272,1890,3382,195,82,420,2,19,10,35,11,36,10
R35215,éRå˚åß,é¸ìÏés,137540,66686,70854,132140,63816,68324,15493,7914,7579,72235,36833,35402,44734,19145,25589,23199,9058,14141,1162,824,1705,13,117,63,361,92,375,25
R35216,éRå˚åß,éRózè¨ñÏìcés,60326,28635,31691,59330,28116,31214,7337,3778,3559,32095,16079,16016,20451,8554,11897,10449,3831,6618,627,350,821,5,61,32,159,49,222,17
R35305,éRå˚åß,é¸ñhëÂìáí¨,14798,6828,7970,14699,6796,7903,934,492,442,5778,2935,2843,8071,3387,4684,4810,1791,3019,99,40,424,2,14,8,30,12,31,12
R35321,éRå˚åß,òañÿí¨,6034,2947,3087,5929,2891,3038,1010,507,503,3349,1680,1669,1646,740,906,831,313,518,77,57,64,0,5,2,5,3,7,1
R35341,éRå˚åß,è„ä÷í¨,2342,1084,1258,2338,1082,1256,147,66,81,874,487,387,1321,531,790,804,280,524,4,11,81,0,8,2,2,1,0,2
R35343,éRå˚åß,ìcïzé{í¨,14483,6908,7575,14387,6873,7514,1558,779,779,7651,3825,3826,5230,2279,2951,2783,1138,1645,59,51,221,0,6,6,7,6,5,4
R35344,éRå˚åß,ïΩê∂í¨,11914,5553,6361,11799,5509,6290,1083,551,532,5654,2781,2873,5138,2200,2938,3005,1168,1837,86,48,179,1,9,4,28,6,33,3
R35502,éRå˚åß,à¢ïêí¨,3055,1367,1688,3029,1363,1666,262,135,127,1271,624,647,1521,607,914,839,265,574,26,3,65,0,3,1,3,2,2,1
R36201,ìøìáåß,ìøìáés,252391,120188,132203,232205,110343,121862,26272,13371,12901,130393,63687,66706,70811,29640,41171,36470,13664,22806,1506,1903,2788,40,278,173,1441,464,1419,68
R36202,ìøìáåß,ñ¬ñÂés,54622,25858,28764,53818,25540,28278,5592,2911,2681,29282,14365,14917,19121,8296,10825,9554,3700,5854,309,271,755,5,50,28,138,47,251,16
R36203,ìøìáåß,è¨èºìáés,36149,17461,18688,35668,17245,18423,3683,1924,1759,19522,9846,9676,12528,5442,7086,6318,2489,3829,196,196,500,7,26,18,230,41,122,10
R36204,ìøìáåß,à¢ìÏés,69470,33694,35776,68518,33338,35180,8291,4236,4055,37365,19125,18240,23131,10037,13094,11908,4652,7256,292,408,941,5,59,33,124,51,130,28
R36205,ìøìáåß,ãgñÏêÏés,38772,18231,20541,38028,17920,20108,3896,1976,1920,19597,9562,10035,14666,6346,8320,7688,2942,4746,306,221,609,4,48,27,146,40,104,9
R36206,ìøìáåß,à¢îgés,34713,16476,18237,34280,16351,17929,3531,1794,1737,17908,8814,9094,13202,5832,7370,6519,2511,4008,390,165,617,3,28,19,39,34,31,9
R36207,ìøìáåß,î¸înés,28055,13342,14713,27647,13202,14445,2767,1463,1304,14275,7137,7138,10953,4701,6252,5697,2030,3667,403,125,466,5,29,16,50,19,62,5
R36208,ìøìáåß,éOçDés,23605,11117,12488,23418,11066,12352,1961,1014,947,10739,5497,5242,10868,4580,6288,6150,2163,3987,187,83,580,4,26,13,68,16,51,11
R36301,ìøìáåß,èüâYí¨,4837,2317,2520,4806,2308,2498,433,235,198,2275,1157,1118,2128,924,1204,1194,442,752,31,19,85,1,1,2,4,2,5,2
R36302,ìøìáåß,è„èüí¨,1380,651,729,1375,649,726,97,47,50,511,268,243,772,336,436,529,210,319,5,7,25,0,4,0,1,0,1,1
R36321,ìøìáåß,ç≤ìﬂâÕì‡ë∫,2058,998,1060,2053,996,1057,163,94,69,909,472,437,986,432,554,527,209,318,5,8,33,0,2,0,2,0,1,1
R36341,ìøìáåß,êŒà‰í¨,24833,11752,13081,24510,11651,12859,3045,1573,1472,13480,6529,6951,8199,3587,4612,4060,1601,2459,237,152,337,1,22,17,37,17,59,7
R36342,ìøìáåß,ê_éRí¨,4647,2183,2464,4593,2167,2426,277,157,120,1845,948,897,2525,1078,1447,1466,513,953,54,24,135,0,5,3,4,3,5,2
R36368,ìøìáåß,ìﬂâÍí¨,7367,3521,3846,7350,3513,3837,559,298,261,2981,1589,1392,3808,1621,2187,2251,834,1417,12,27,179,1,10,2,10,3,19,4
R36383,ìøìáåß,ñ¥äÚí¨,3743,1735,2008,3722,1726,1996,232,117,115,1495,775,720,2016,843,1173,1203,453,750,21,7,85,1,7,3,19,4,16,1
R36387,ìøìáåß,î¸îgí¨,6222,2923,3299,6168,2907,3261,482,237,245,2668,1378,1290,3071,1308,1763,1852,709,1143,54,25,117,1,8,3,11,3,15,4
R36388,ìøìáåß,äCózí¨,8358,3965,4393,8143,3884,4259,623,329,294,3813,1894,1919,3873,1710,2163,2132,845,1287,213,30,192,1,6,7,8,9,25,4
R36401,ìøìáåß,èºñŒí¨,14583,7193,7390,14446,7141,7305,1879,950,929,8772,4503,4269,3916,1732,2184,1865,742,1123,114,107,171,2,10,6,21,12,31,3
R36402,ìøìáåß,ñkìáí¨,22745,10976,11769,22366,10776,11590,3410,1768,1642,13241,6522,6719,5799,2527,3272,2773,1090,1683,112,201,194,2,22,15,63,24,108,9
R36403,ìøìáåß,óïèZí¨,35246,16868,18378,34653,16557,18096,5186,2666,2520,20635,9925,10710,8993,4031,4962,3961,1576,2385,193,301,295,2,31,17,55,26,60,6
R36404,ìøìáåß,î¬ñÏí¨,13042,6262,6780,12842,6201,6641,1400,741,659,7226,3597,3629,4375,1898,2477,2089,793,1296,162,82,171,2,12,6,35,8,46,1
R36405,ìøìáåß,è„î¬í¨,11384,5431,5953,11270,5379,5891,1202,622,580,6141,3022,3119,4040,1786,2254,1870,716,1154,112,61,177,0,9,7,21,10,14,1
R36468,ìøìáåß,Ç¬ÇÈÇ¨í¨,7715,3608,4107,7685,3599,4086,583,324,259,3531,1769,1762,3596,1512,2084,2062,731,1331,30,19,201,3,6,4,18,4,23,2
R36489,ìøìáåß,ìåÇ›ÇÊÇµí¨,13622,6515,7107,13520,6473,7047,1565,791,774,7053,3541,3512,4969,2159,2810,2534,904,1630,89,79,233,2,9,7,22,12,21,3
R37201,çÅêÏåß,çÇèºés,417496,202029,215467,399190,192046,207144,52018,26622,25396,233651,116433,117218,115270,49699,65571,58060,22750,35310,3577,3085,4566,30,405,233,1262,356,1207,87
R37202,çÅêÏåß,ä€ãTés,109513,53018,56495,106424,51377,55047,14667,7513,7154,61951,31022,30929,31435,13760,17675,15491,6106,9385,1830,814,1187,9,88,53,245,90,259,31
R37203,çÅêÏåß,ç‚èoés,50624,24145,26479,49498,23615,25883,5584,2868,2716,26502,13342,13160,18171,7709,10462,9670,3674,5996,814,270,774,5,50,29,207,50,156,13
R37204,çÅêÏåß,ëPí éõés,31631,15725,15906,31105,15467,15638,3866,1978,1888,17733,9406,8327,9666,4160,5506,4968,1899,3069,260,228,420,3,32,14,131,22,78,6
R37205,çÅêÏåß,äœâπéõés,57438,27578,29860,56249,27078,29171,6689,3464,3225,30577,15344,15233,19433,8329,11104,10383,3999,6384,739,332,872,4,48,27,187,43,149,12
R37206,çÅêÏåß,Ç≥Ç Ç´és,47003,22484,24519,46251,22136,24115,4566,2292,2274,24407,12314,12093,17369,7567,9802,9330,3692,5638,383,187,668,2,41,24,84,30,131,11
R37207,çÅêÏåß,ìåÇ©Ç™ÇÌés,28279,13358,14921,27964,13246,14718,2467,1242,1225,13640,6787,6853,11990,5244,6746,6654,2641,4013,235,116,486,3,19,14,49,18,81,6
R37208,çÅêÏåß,éOñLés,61857,29770,32087,60930,29374,31556,6963,3558,3405,32067,16271,15796,22573,9810,12763,12081,4716,7365,719,311,1042,7,41,21,78,33,89,12
R37322,çÅêÏåß,ìyèØí¨,12846,6044,6802,12763,6019,6744,1222,618,604,6072,3021,3051,5528,2385,3143,2878,1076,1802,78,61,221,0,9,5,6,5,17,7
R37324,çÅêÏåß,è¨ì§ìáí¨,13870,6621,7249,13731,6571,7160,1238,641,597,6500,3350,3150,6117,2616,3501,3441,1312,2129,134,62,274,2,7,5,35,6,36,3
R37341,çÅêÏåß,éOñÿí¨,26878,12943,13935,26454,12734,13720,3441,1764,1677,14700,7211,7489,8445,3802,4643,4118,1684,2434,201,169,367,3,17,11,451,33,108,7
R37364,çÅêÏåß,íºìáí¨,3103,1646,1457,3067,1630,1437,312,155,157,1691,973,718,1027,463,564,557,224,333,29,25,54,0,2,1,2,1,1,1
R37386,çÅêÏåß,âFëΩí√í¨,18699,9180,9519,17973,8845,9128,2655,1356,1299,11637,5877,5760,3964,1719,2245,2028,774,1254,404,170,157,1,11,7,21,14,42,5
R37387,çÅêÏåß,àªêÏí¨,22693,10999,11694,22345,10790,11555,2618,1338,1280,11814,5943,5871,8188,3674,4514,4062,1629,2433,284,114,326,2,19,7,65,10,67,6
R37403,çÅêÏåß,ã’ïΩí¨,8468,3938,4530,8284,3837,4447,772,412,360,4201,2086,2115,3471,1424,2047,1931,694,1237,168,35,193,2,10,5,15,6,23,3
R37404,çÅêÏåß,ëΩìxí√í¨,22445,11373,11072,21474,10603,10871,2568,1319,1249,12310,6679,5631,7244,3123,4121,3725,1457,2268,816,109,283,3,15,7,29,14,40,5
R37406,çÅêÏåß,Ç‹ÇÒÇÃÇ§í¨,17401,8346,9055,17182,8276,8906,2111,1100,1011,8603,4374,4229,6642,2847,3795,3524,1320,2204,183,91,293,1,14,6,19,8,26,5
R38201,à§ïQåß,èºéRés,511192,240292,270900,489817,229315,260502,61680,31519,30161,286198,137229,148969,139574,58123,81451,70640,26426,44214,2672,3437,5673,36,488,252,1645,366,1386,77
R38202,à§ïQåß,ç°é°és,151672,71799,79873,147778,69509,78269,16907,8635,8272,79655,39899,39756,53977,22710,31267,28490,10825,17665,3043,838,2186,27,113,82,343,116,319,34
R38203,à§ïQåß,âFòaìáés,70809,33213,37596,70122,32914,37208,7204,3795,3409,34997,17458,17539,28193,11687,16506,14732,5261,9471,365,344,1261,6,75,42,208,53,168,23
R38204,à§ïQåß,î™î¶ïlés,31987,14971,17016,31684,14866,16818,3055,1565,1490,15625,7815,7810,13094,5452,7642,7159,2630,4529,210,148,540,4,41,17,88,21,77,9
R38205,à§ïQåß,êVãèïlés,115938,56004,59934,113361,54678,58683,14205,7303,6902,62529,31991,30538,37325,15559,21766,19612,7323,12289,1206,776,1577,9,85,51,275,93,238,29
R38206,à§ïQåß,êºèés,104791,50615,54176,102779,49317,53462,12925,6571,6354,56521,28874,27647,34403,14638,19765,18067,6844,11223,1299,697,1494,9,87,52,190,74,199,32
R38207,à§ïQåß,ëÂèFés,40575,19423,21152,39996,19154,20842,4560,2344,2216,20500,10293,10207,14954,6457,8497,7995,3026,4969,169,235,621,5,55,25,112,29,90,16
R38210,à§ïQåß,à…ó\és,35133,16385,18748,34808,16288,18520,4295,2242,2053,18720,9045,9675,11996,5046,6950,6168,2287,3881,211,179,501,1,29,14,48,19,48,11
R38213,à§ïQåß,élçëíÜâõés,82754,40468,42286,78462,38609,39853,8843,4546,4297,42207,21567,20640,26658,11542,15116,13638,5230,8408,719,558,1145,8,54,35,161,46,150,24
R38214,à§ïQåß,êºó\és,35388,16635,18753,35049,16552,18497,3571,1840,1731,16127,8186,7941,15578,6554,9024,8875,3301,5574,274,175,654,3,40,18,48,19,56,14
R38215,à§ïQåß,ìåâ∑és,33903,16180,17723,33378,15889,17489,4147,2100,2047,19105,9378,9727,10216,4444,5772,5095,1965,3130,168,192,396,4,29,13,567,40,154,5
R38356,à§ïQåß,è„ìáí¨,6509,3421,3088,6196,3127,3069,455,235,220,3088,1884,1204,2953,1293,1660,1592,617,975,306,19,106,0,5,2,5,3,1,3
R38386,à§ïQåß,ãvñúçÇå¥í¨,7404,3513,3891,7325,3483,3842,551,282,269,3110,1645,1465,3655,1542,2113,2324,872,1452,34,23,165,1,11,4,13,5,12,1
R38401,à§ïQåß,èºëOí¨,29630,13911,15719,29402,13823,15579,3933,2000,1933,16323,7906,8417,9267,3941,5326,4799,1881,2918,141,187,345,1,23,15,33,19,38,7
R38402,à§ïQåß,ìuïîí¨,20480,9519,10961,20255,9432,10823,2425,1209,1216,10864,5193,5671,6987,3017,3970,3505,1374,2131,73,91,251,1,17,8,31,9,23,4
R38422,à§ïQåß,ì‡éqí¨,15322,7303,8019,15268,7299,7969,1610,854,756,7437,3728,3709,6267,2714,3553,3532,1364,2168,53,79,257,1,14,8,19,8,16,5
R38442,à§ïQåß,à…ï˚í¨,8397,4036,4361,8330,4018,4312,636,322,314,3780,2012,1768,3979,1701,2278,2245,807,1438,67,20,185,0,10,4,6,4,1,6
R38484,à§ïQåß,èºñÏí¨,3674,1725,1949,3656,1725,1931,303,143,160,1635,842,793,1733,738,995,963,364,599,18,13,89,0,6,2,3,2,3,1
R38488,à§ïQåß,ãSñkí¨,9682,4463,5219,9596,4451,5145,874,475,399,4280,2087,2193,4528,1901,2627,2532,929,1603,86,30,214,2,12,4,20,5,13,7
R38506,à§ïQåß,à§ìÏí¨,19601,9186,10415,19544,9153,10391,1585,825,760,9037,4517,4520,8942,3818,5124,4573,1719,2854,45,61,376,3,19,9,32,12,32,9
R39201,çÇímåß,çÇímés,326545,152455,174090,317204,147276,169928,38125,19395,18730,182962,88347,94615,95909,39118,56791,49765,17917,31848,1493,2163,3797,54,256,194,1274,279,1042,93
R39202,çÇímåß,é∫åÀés,11742,5648,6094,11649,5571,6078,801,409,392,4850,2593,2257,6040,2618,3422,3205,1294,1911,91,40,244,1,7,6,9,7,10,7
R39203,çÇímåß,à¿å|és,16243,7754,8489,16062,7657,8405,1490,766,724,7941,4057,3884,6638,2823,3815,3570,1367,2203,67,77,289,2,14,8,71,11,42,8
R39204,çÇímåß,ìÏçëés,46664,22130,24534,45890,21800,24090,5633,2876,2757,25521,12694,12827,14850,6231,8619,7825,2847,4978,275,315,541,9,30,17,459,33,180,17
R39205,çÇímåß,ìyç≤és,25732,12384,13348,25342,12164,13178,2842,1496,1346,13332,6816,6516,9463,4018,5445,5088,1921,3167,348,184,381,3,16,10,53,13,59,12
R39206,çÇímåß,ê{çËés,20590,10068,10522,20162,9782,10380,1940,988,952,10177,5404,4773,8356,3595,4761,4642,1786,2856,390,86,363,3,10,10,44,13,48,7
R39208,çÇímåß,èhñ—és,19033,8914,10119,18805,8825,9980,1980,998,982,9209,4607,4602,7367,3067,4300,3733,1375,2358,68,82,283,5,13,12,85,15,55,9
R39209,çÇímåß,ìyç≤ê¥êÖés,12388,5842,6546,12301,5794,6507,895,461,434,5220,2650,2570,6259,2720,3539,3514,1394,2120,79,35,259,3,7,5,14,9,19,5
R39210,çÇímåß,élñúè\és,32694,15455,17239,32449,15357,17092,3644,1838,1806,16570,8280,8290,12018,5045,6973,6373,2333,4040,93,219,513,7,26,19,58,23,77,18
R39211,çÇímåß,çÅìÏés,32207,15545,16662,31744,15289,16455,3949,2033,1916,17585,8945,8640,10452,4432,6020,5496,2089,3407,289,209,405,1,25,13,36,19,28,8
R39212,çÇímåß,çÅî¸és,26513,12848,13665,25915,12568,13347,2632,1353,1279,13352,7121,6231,10123,4156,5967,5797,2103,3694,287,146,425,3,21,12,32,16,47,7
R39301,çÇímåß,ìåómí¨,2194,1085,1109,2153,1054,1099,133,66,67,945,528,417,1116,491,625,618,252,366,41,6,67,0,2,1,2,1,3,2
R39302,çÇímåß,ìﬁîºóòí¨,3034,1399,1635,3015,1389,1626,254,140,114,1353,679,674,1418,574,844,819,290,529,11,19,56,0,4,3,5,3,8,1
R39303,çÇímåß,ìcñÏí¨,2498,1174,1324,2491,1174,1317,235,112,123,1182,614,568,1060,436,624,629,219,410,7,13,40,1,1,2,7,2,12,1
R39304,çÇímåß,à¿ìcí¨,2370,1144,1226,2365,1141,1224,210,111,99,1069,561,508,1081,463,618,636,252,384,5,15,60,0,1,1,2,1,4,1
R39305,çÇímåß,ñkêÏë∫,1146,552,594,1143,550,593,102,49,53,539,291,248,505,212,293,291,109,182,3,8,24,0,0,0,0,0,0,1
R39306,çÇímåß,înòHë∫,745,358,387,743,356,387,82,38,44,358,186,172,305,134,171,188,75,113,2,6,16,0,2,0,0,0,0,2
R39307,çÇímåß,å|êºë∫,3694,1724,1970,3620,1683,1937,399,203,196,1806,936,870,1489,585,904,823,285,538,74,20,68,1,3,1,9,2,7,1
R39341,çÇímåß,ñ{éRí¨,3261,1516,1745,3239,1511,1728,280,130,150,1419,758,661,1560,627,933,973,334,639,22,11,68,1,2,1,7,1,7,1
R39344,çÇímåß,ëÂñLí¨,3252,1546,1706,3219,1535,1684,183,98,85,1160,631,529,1907,816,1091,1164,422,742,33,9,111,1,7,1,3,2,1,3
R39363,çÇímåß,ìyç≤í¨,3753,1780,1973,3720,1776,1944,363,193,170,1588,833,755,1801,753,1048,1136,431,705,33,20,76,1,4,1,6,3,6,1
R39364,çÇímåß,ëÂêÏë∫,366,189,177,365,188,177,45,24,21,171,96,75,150,69,81,95,34,61,1,0,10,0,1,0,0,0,0,0
R39386,çÇímåß,Ç¢ÇÃí¨,21374,10179,11195,21214,10098,11116,2042,1047,995,10725,5349,5376,8404,3645,4759,4384,1683,2701,38,104,360,3,19,9,35,12,41,8
R39387,çÇímåß,êmóÑêÏí¨,4827,2306,2521,4788,2287,2501,347,194,153,1790,975,815,2685,1134,1551,1701,619,1082,38,12,126,1,5,1,5,2,3,4
R39401,çÇímåß,íÜìyç≤í¨,6002,2782,3220,5960,2750,3210,502,235,267,2602,1321,1281,2895,1224,1671,1650,595,1055,42,20,146,1,7,2,5,2,5,3
R39402,çÇímåß,ç≤êÏí¨,12323,5751,6572,12252,5729,6523,1327,671,656,5916,2891,3025,5058,2173,2885,2845,1092,1753,56,53,211,2,10,3,22,4,25,7
R39403,çÇímåß,âzímí¨,5187,2390,2797,5171,2387,2784,421,213,208,2323,1164,1159,2441,1013,1428,1478,542,936,16,18,133,4,2,2,16,2,16,1
R39405,çÇímåß,ûçå¥í¨,3307,1611,1696,3302,1607,1695,320,158,162,1456,784,672,1531,669,862,885,342,543,5,14,58,1,4,1,7,2,4,1
R39410,çÇímåß,ì˙çÇë∫,4812,2282,2530,4794,2277,2517,432,236,196,2307,1162,1145,2073,884,1189,1133,419,714,18,28,81,0,4,1,1,1,2,2
R39411,çÇímåß,í√ñÏí¨,5291,2516,2775,5263,2511,2752,552,286,266,2351,1201,1150,2388,1029,1359,1399,519,880,28,17,111,0,5,2,3,2,3,2
R39412,çÇímåß,élñúè\í¨,15607,7442,8165,15472,7398,8074,1479,770,709,7061,3624,3437,6979,2995,3984,3944,1491,2453,84,79,347,2,13,7,28,9,25,11
R39424,çÇímåß,ëÂåéí¨,4434,2128,2306,4415,2115,2300,312,155,157,1946,1004,942,2176,969,1207,1162,432,730,19,9,114,1,2,2,3,2,5,1
R39427,çÇímåß,éOå¥ë∫,1437,690,747,1424,685,739,104,63,41,657,358,299,676,269,407,427,159,268,13,6,24,0,2,1,1,0,0,1
R39428,çÇímåß,çïí™í¨,10262,4944,5318,10111,4831,5280,891,467,424,4757,2487,2270,4614,1990,2624,2405,922,1483,151,39,191,0,8,6,3,6,3,4
R40100,ïüâ™åß,ñkã„èBés,939029,443269,495760,898013,423283,474730,109590,55857,53733,503800,247580,256220,286177,117819,168358,150527,55566,94961,10815,6459,11256,77,944,637,3490,1233,2384,166
R40130,ïüâ™åß,ïüâ™és,1612392,761148,851244,1504528,705628,798900,204973,104834,100139,990298,475234,515064,338930,140781,198149,163995,59737,104258,31904,13079,12588,101,1598,1025,6490,2265,4917,278
R40202,ïüâ™åß,ëÂñ¥ìcés,111281,51262,60019,109466,50476,58990,12194,6271,5923,56397,27655,28742,41290,16663,24627,21862,7559,14303,662,678,1859,19,117,74,411,112,301,23
R40203,ïüâ™åß,ãvóØïƒés,303316,144522,158794,279016,132557,146459,37877,19379,18498,160800,78227,82573,80051,33470,46581,39991,14786,25205,2895,2477,3238,27,312,192,1808,315,916,75
R40204,ïüâ™åß,íºï˚és,56212,26403,29809,55438,25964,29474,7336,3839,3497,29633,14766,14867,19005,7678,11327,10208,3625,6583,566,409,744,4,68,40,130,73,114,14
R40205,ïüâ™åß,î—íÀés,126364,60174,66190,124259,59037,65222,16215,8306,7909,68782,34585,34197,39727,16235,23492,19681,6892,12789,1211,933,1557,11,133,72,599,123,366,30
R40206,ïüâ™åß,ìcêÏés,46203,21056,25147,45379,20689,24690,5711,2831,2880,23890,11510,12380,15939,6386,9553,8147,2813,5334,401,331,651,5,51,24,180,55,158,20
R40207,ïüâ™åß,ñˆêÏés,64475,30437,34038,63541,29932,33609,7632,3912,3720,34830,17167,17663,21580,9103,12477,11291,4228,7063,534,404,866,6,60,40,126,54,132,21
R40210,ïüâ™åß,î™èóés,60608,28451,32157,59770,28147,31623,7024,3581,3443,30942,15283,15659,22037,9287,12750,11902,4352,7550,436,380,937,7,58,36,174,56,124,18
R40211,ïüâ™åß,í}å„és,48827,23400,25427,48146,23100,25046,7103,3635,3468,28176,13859,14317,13329,5761,7568,6650,2553,4097,495,424,517,2,50,28,95,34,108,13
R40212,ïüâ™åß,ëÂêÏés,32988,15427,17561,32633,15268,17365,3451,1720,1731,17544,8546,8998,11791,5071,6720,6418,2526,3892,218,196,473,2,31,17,162,30,89,9
R40213,ïüâ™åß,çsã¥és,71426,34120,37306,69983,33359,36624,9417,4833,4584,39439,19620,19819,21649,9132,12517,10853,4093,6760,557,566,810,6,58,44,135,66,157,12
R40214,ïüâ™åß,ñLëOés,24391,11378,13013,23943,11157,12786,2818,1422,1396,12298,6105,6193,9127,3779,5348,4883,1769,3114,326,132,375,1,28,17,36,27,44,10
R40215,ïüâ™åß,íÜä‘és,40362,18961,21401,39786,18585,21201,4405,2297,2108,20583,10209,10374,15106,6266,8840,7949,3007,4942,337,262,550,2,33,24,53,32,69,6
R40216,ïüâ™åß,è¨åSés,59360,27825,31535,58257,27311,30946,8115,4093,4022,33967,16295,17672,16834,7216,9618,8750,3382,5368,869,374,579,7,54,35,141,47,123,13
R40217,ïüâ™åß,í}éáñÏés,103311,49289,54022,101594,48276,53318,14813,7618,7195,60682,29282,31400,26417,11546,14871,12055,4746,7309,533,854,923,8,77,53,300,74,255,13
R40218,ïüâ™åß,ètì˙és,111023,53099,57924,108364,51906,56458,16905,8758,8147,67730,32786,34944,24377,10716,13661,11259,4522,6737,766,877,753,5,82,57,294,89,226,12
R40219,ïüâ™åß,ëÂñÏèÈés,102085,48887,53198,99328,47262,52066,15654,8002,7652,61537,29836,31701,22374,9678,12696,10757,4191,6566,783,961,717,7,67,53,98,80,177,18
R40220,ïüâ™åß,è@ëúés,97095,46143,50952,94596,45081,49515,13338,6815,6523,53601,26165,27436,28276,12312,15964,13885,5510,8375,726,767,962,7,73,48,158,84,178,16
R40221,ïüâ™åß,ëæç…ï{és,73164,34743,38421,71500,33787,37713,10355,5323,5032,41044,19765,21279,20332,8781,11551,10252,4138,6114,445,545,638,3,42,32,67,46,121,11
R40223,ïüâ™åß,å√âÍés,58786,27924,30862,57941,27540,30401,8364,4254,4110,34049,16529,17520,16247,7054,9193,7534,2937,4597,781,452,511,5,40,38,206,50,105,10
R40224,ïüâ™åß,ïüí√és,67033,31286,35747,66116,30887,35229,10984,5580,5404,36478,17424,19054,18887,8008,10879,9575,3687,5888,394,690,607,4,51,35,149,60,132,11
R40225,ïüâ™åß,Ç§Ç´ÇÕés,27981,13145,14836,27624,12982,14642,3377,1757,1620,13999,6975,7024,9876,4031,5845,5166,1788,3378,241,160,409,2,29,15,47,22,50,8
R40226,ïüâ™åß,ã{é·és,26298,12379,13919,25856,12148,13708,3141,1612,1529,13393,6732,6661,9644,3975,5669,5015,1693,3322,362,192,426,4,19,15,55,25,42,5
R40227,ïüâ™åß,â√ñÉés,35473,16400,19073,35211,16275,18936,3893,2004,1889,17155,8529,8626,14340,5797,8543,7225,2431,4794,258,169,611,6,25,20,51,35,51,13
R40228,ïüâ™åß,í©ëqés,50273,23546,26727,49166,23062,26104,6071,3025,3046,26115,12867,13248,17523,7369,10154,8866,3179,5687,658,308,734,4,52,31,128,42,141,15
R40229,ïüâ™åß,Ç›Ç‚Ç‹és,35861,16675,19186,35576,16587,18989,3992,2002,1990,18024,8757,9267,13749,5864,7885,7122,2659,4463,260,197,575,1,32,16,64,26,65,14
R40230,ïüâ™åß,éÖìáés,98877,46984,51893,97546,46316,51230,13669,7068,6601,55280,26838,28442,29578,12892,16686,13826,5411,8415,1160,630,1026,6,84,45,166,75,194,20
R40231,ïüâ™åß,ìﬂâœêÏés,50112,24194,25918,49561,23865,25696,8136,4118,4018,29916,14647,15269,11704,5210,6494,5237,2140,3097,285,415,399,1,32,23,34,35,61,7
R40341,ïüâ™åß,âFî¸í¨,37671,18964,18707,37066,18559,18507,5331,2757,2574,21789,11356,10433,10408,4758,5650,4303,1714,2589,486,246,362,3,17,16,39,21,49,9
R40342,ïüâ™åß,é¬åIí¨,31209,15014,16195,30957,14881,16076,4654,2416,2238,18481,9106,9375,7985,3448,4537,3957,1562,2395,178,279,254,4,13,9,62,17,34,4
R40343,ïüâ™åß,éuñ∆í¨,46377,22291,24086,45661,21918,23743,7487,3821,3666,27314,13498,13816,11034,4571,6463,5479,2014,3465,602,423,368,4,35,22,106,43,93,9
R40344,ïüâ™åß,ê{åbí¨,28628,13760,14868,28155,13502,14653,4777,2475,2302,15750,7847,7903,7847,3324,4523,3796,1452,2344,255,263,292,2,13,7,34,10,38,5
R40345,ïüâ™åß,êVã{í¨,32927,15894,17033,32367,15633,16734,6820,3395,3425,19912,9728,10184,6024,2663,3361,2682,1024,1658,430,325,232,2,30,16,41,21,72,7
R40348,ïüâ™åß,ãvéRí¨,9068,4281,4787,8797,4234,4563,1511,786,725,5048,2440,2608,2471,1031,1440,1262,481,781,247,82,93,1,8,4,14,5,21,1
R40349,ïüâ™åß,îîâÆí¨,48190,23840,24350,47148,23252,23896,8617,4361,4256,30431,15424,15007,8514,3664,4850,3963,1523,2440,614,612,299,3,26,21,100,37,84,10
R40381,ïüâ™åß,à∞âÆí¨,13545,6629,6916,13455,6578,6877,1645,800,845,7531,4003,3528,4363,1822,2541,2320,861,1459,85,101,184,1,9,4,29,14,15,4
R40382,ïüâ™åß,êÖä™í¨,28114,13074,15040,27605,12843,14762,3500,1754,1746,15191,7424,7767,9305,3851,5454,4627,1680,2947,418,194,359,3,21,16,83,22,63,7
R40383,ïüâ™åß,â™ä_í¨,31007,14481,16526,30808,14377,16431,4075,2104,1971,16217,7827,8390,10309,4369,5940,5430,2085,3345,166,183,397,1,23,11,37,16,41,4
R40384,ïüâ™åß,âìâÍí¨,18723,8795,9928,18505,8700,9805,2387,1229,1158,9789,4722,5067,6497,2821,3676,3252,1303,1949,197,118,236,4,13,7,52,10,48,3
R40401,ïüâ™åß,è¨í|í¨,7151,3406,3745,6955,3246,3709,605,317,288,3523,1865,1658,3021,1224,1797,1533,558,975,196,26,132,1,6,5,6,9,8,1
R40402,ïüâ™åß,à∆éËí¨,15080,7074,8006,14885,6951,7934,1653,825,828,7501,3753,3748,5915,2487,3428,2878,1057,1821,189,63,257,1,7,6,26,8,14,3
R40421,ïüâ™åß,åjêÏí¨,12878,6018,6860,12776,5968,6808,1618,853,765,6690,3252,3438,4523,1905,2618,2062,729,1333,102,85,174,1,8,5,11,10,8,3
R40447,ïüâ™åß,í}ëOí¨,29591,14061,15530,29320,13941,15379,4128,2115,2013,16156,7997,8159,9238,3903,5335,4499,1647,2852,225,247,320,2,18,10,31,12,28,5
R40448,ïüâ™åß,ìåïÙë∫,1899,868,1031,1888,861,1027,184,90,94,846,419,427,869,359,510,493,155,338,11,8,57,0,5,2,2,1,0,2
R40503,ïüâ™åß,ëÂìÅêÙí¨,15521,7438,8083,15193,7286,7907,2339,1206,1133,8798,4340,4458,4351,1873,2478,2088,754,1334,316,158,155,1,8,7,12,10,9,5
R40522,ïüâ™åß,ëÂñÿí¨,13820,6545,7275,13687,6502,7185,2097,1071,1026,7666,3749,3917,4036,1714,2322,1974,729,1245,120,109,177,1,13,6,18,8,23,4
R40544,ïüâ™åß,çLêÏí¨,19969,9589,10380,19494,9353,10141,2671,1343,1328,10991,5565,5426,6002,2511,3491,3213,1165,2048,270,124,234,4,14,11,44,16,40,5
R40601,ïüâ™åß,çÅètí¨,10191,4737,5454,10141,4712,5429,1135,568,567,4795,2366,2429,4238,1786,2452,2191,801,1390,49,60,167,0,5,5,1,6,9,5
R40602,ïüâ™åß,ìYìcí¨,8801,4128,4673,8791,4125,4666,856,449,407,4018,2032,1986,3926,1647,2279,1996,730,1266,9,32,175,1,12,7,11,9,8,6
R40604,ïüâ™åß,éÖìcí¨,8407,3843,4564,8369,3821,4548,1135,572,563,4055,1959,2096,3215,1310,1905,1663,578,1085,38,46,158,1,8,4,12,6,16,3
R40605,ïüâ™åß,êÏçËí¨,15176,6918,8258,15077,6874,8203,1787,921,866,7456,3557,3899,5932,2439,3493,2946,1030,1916,99,92,263,4,8,11,20,11,27,9
R40608,ïüâ™åß,ëÂîCí¨,5008,2262,2746,4999,2262,2737,731,381,350,2327,1112,1215,1948,767,1181,1020,347,673,9,32,91,0,6,2,6,6,4,3
R40609,ïüâ™åß,ê‘ë∫,2774,1295,1479,2771,1294,1477,352,181,171,1301,630,671,1119,483,636,531,196,335,3,13,58,0,4,1,1,4,2,3
R40610,ïüâ™åß,ïüíqí¨,21398,9984,11414,21277,9925,11352,2691,1402,1289,10637,5192,5445,8066,3387,4679,4070,1449,2621,121,126,370,2,13,9,26,15,19,12
R40621,ïüâ™åß,ä°ìcí¨,37684,19639,18045,35390,18280,17110,5185,2700,2485,21919,12031,9888,8879,3867,5012,4323,1687,2636,1050,316,354,3,26,20,68,30,64,7
R40625,ïüâ™åß,Ç›Ç‚Ç±í¨,18825,8803,10022,18675,8711,9964,1907,961,946,8998,4482,4516,7915,3358,4557,4220,1541,2679,147,98,307,1,13,6,16,7,14,9
R40642,ïüâ™åß,ãgïxí¨,6536,3068,3468,6462,3030,3432,853,429,424,3540,1758,1782,2115,867,1248,1124,421,703,58,51,68,1,9,5,10,8,38,3
R40646,ïüâ™åß,è„ñ—í¨,7251,3453,3798,7217,3439,3778,984,518,466,3651,1805,1846,2615,1129,1486,1382,517,865,34,39,104,0,7,1,3,1,6,3
R40647,ïüâ™åß,ízè„í¨,17189,8272,8917,17048,8198,8850,1911,977,934,8650,4509,4141,6566,2741,3825,3559,1305,2254,97,94,285,1,13,9,16,14,19,9
R41201,ç≤âÍåß,ç≤âÍés,233301,110191,123110,225564,106544,119020,30064,15374,14690,129142,62695,66447,64802,26938,37864,33354,12235,21119,1425,1689,2596,23,233,132,1151,238,754,53
R41202,ç≤âÍåß,ìÇí√és,117373,55015,62358,116391,54731,61660,16016,8273,7743,62594,30479,32115,38363,16034,22329,19481,6995,12486,722,847,1666,15,98,59,300,82,257,44
R41203,ç≤âÍåß,íπê≤és,74196,35528,38668,72035,34354,37681,11203,5766,5437,43865,21501,22364,17938,7566,10372,9061,3385,5676,1064,625,705,7,74,40,172,64,248,20
R41204,ç≤âÍåß,ëΩãvés,18295,8555,9740,18121,8468,9653,2110,1028,1082,9416,4681,4735,6753,2835,3918,3326,1137,2189,165,104,279,2,11,8,27,8,30,13
R41205,ç≤âÍåß,à…ñúó¢és,52629,25445,27184,51983,25010,26973,7293,3736,3557,28119,14359,13760,16919,7154,9765,8473,3019,5454,447,371,722,7,38,25,83,28,85,24
R41206,ç≤âÍåß,ïêóYés,47914,22727,25187,47438,22537,24901,6547,3401,3146,25940,12765,13175,15064,6377,8687,7670,2758,4912,209,378,603,4,46,23,109,31,113,15
R41207,ç≤âÍåß,é≠ìáés,27892,13140,14752,27705,13059,14646,3784,1964,1820,14918,7231,7687,9141,3914,5227,4653,1759,2894,157,201,367,4,18,14,55,15,44,15
R41208,ç≤âÍåß,è¨èÈés,43952,20772,23180,43559,20626,22933,6124,3109,3015,24623,11903,12720,12599,5446,7153,6215,2312,3903,274,394,472,3,31,20,84,26,82,11
R41209,ç≤âÍåß,äñÏés,25848,11995,13853,25643,11901,13742,3225,1617,1608,13334,6503,6831,9219,3836,5383,4868,1738,3130,157,173,395,4,19,11,160,23,77,11
R41210,ç≤âÍåß,ê_çÈés,31022,14884,16138,30472,14652,15820,3934,2047,1887,16890,8427,8463,9762,4176,5586,4954,1858,3096,206,215,380,3,23,15,33,19,44,10
R41327,ç≤âÍåß,ãgñÏÉñó¢í¨,16323,7990,8333,16004,7864,8140,2430,1249,1181,9759,4921,4838,3970,1728,2242,1880,721,1159,192,147,153,1,11,6,61,10,42,4
R41341,ç≤âÍåß,äÓéRí¨,17250,8174,9076,16899,8045,8854,2169,1100,1069,9595,4574,5021,5344,2419,2925,2425,977,1448,247,125,181,1,14,8,18,10,26,3
R41345,ç≤âÍåß,è„ïÙí¨,9286,4455,4831,9017,4327,4690,1391,734,657,5258,2544,2714,2422,1057,1365,1167,455,712,56,85,88,1,5,4,9,4,10,3
R41346,ç≤âÍåß,Ç›Ç‚Ç´í¨,25511,12170,13341,25291,12090,13201,3337,1730,1607,13258,6587,6671,8842,3815,5027,4501,1776,2725,171,208,301,2,17,14,48,16,43,4
R41387,ç≤âÍåß,å∫äCí¨,5609,3067,2542,5601,3064,2537,610,319,291,3081,1847,1234,1774,762,1012,895,316,579,8,32,77,0,3,2,2,4,4,2
R41401,ç≤âÍåß,óLìcí¨,19010,8780,10230,18862,8720,10142,2433,1218,1215,9841,4808,5033,6717,2746,3971,3540,1247,2293,144,113,271,1,17,7,34,9,28,8
R41423,ç≤âÍåß,ëÂí¨í¨,6293,2903,3390,6269,2893,3376,643,329,314,3072,1511,1561,2566,1054,1512,1265,424,841,16,33,116,1,5,4,10,7,6,1
R41424,ç≤âÍåß,ç]ñkí¨,9566,4460,5106,9493,4447,5046,1434,727,707,5366,2592,2774,2723,1121,1602,1394,455,939,67,112,114,2,6,5,17,5,12,3
R41425,ç≤âÍåß,îíêŒí¨,22051,10358,11693,21874,10312,11562,2605,1378,1227,11436,5675,5761,7984,3291,4693,4351,1466,2885,156,112,338,4,19,9,60,13,39,9
R41441,ç≤âÍåß,ëæó«í¨,8121,3842,4279,8064,3820,4244,889,456,433,4072,2058,2014,3159,1327,1832,1772,671,1101,57,40,139,1,3,3,12,5,8,4
R42201,í∑çËåß,í∑çËés,409118,188519,220599,401784,184557,217227,46771,23975,22796,223535,106195,117340,132604,54621,77983,66770,24031,42739,2601,2608,5205,37,521,267,2048,566,1264,118
R42202,í∑çËåß,ç≤ê¢ï€és,243223,115131,128092,239760,113274,126486,31507,16035,15472,131710,65430,66280,77173,32069,45104,39263,14207,25056,1611,1881,3285,18,221,130,719,188,515,76
R42203,í∑çËåß,ìáå¥és,43338,20157,23181,42870,19982,22888,5462,2841,2621,22194,10831,11363,15523,6388,9135,8310,3026,5284,361,283,639,7,39,29,125,42,111,26
R42204,í∑çËåß,Ê|ëÅés,133852,63544,70308,132986,63192,69794,17924,9307,8617,75013,36789,38224,40900,17439,23461,20534,7737,12797,866,957,1592,15,129,65,388,111,282,55
R42205,í∑çËåß,ëÂë∫és,95397,45448,49949,94077,44705,49372,14964,7696,7268,55134,26664,28470,24034,10309,13725,11683,4454,7229,362,894,913,6,91,49,415,70,199,34
R42207,í∑çËåß,ïΩåÀés,29365,13771,15594,29180,13692,15488,3382,1730,1652,13778,6995,6783,12151,5015,7136,6615,2263,4352,154,192,560,6,19,11,53,16,42,17
R42208,í∑çËåß,èºâYés,21271,10278,10993,21012,10181,10831,2575,1278,1297,10573,5481,5092,7843,3353,4490,4066,1464,2602,233,119,364,2,17,7,20,11,14,14
R42209,í∑çËåß,ëŒînés,28502,14060,14442,28322,13977,14345,3311,1751,1560,14166,7548,6618,10989,4736,6253,5615,2132,3483,150,163,487,2,34,14,57,17,45,8
R42210,í∑çËåß,àÎäÚés,24948,11837,13111,24846,11814,13032,3213,1661,1552,12062,6154,5908,9640,4013,5627,5270,1912,3358,79,156,454,5,16,9,51,12,42,7
R42211,í∑çËåß,å‹ìáés,34391,16141,18250,34220,16070,18150,3611,1800,1811,16677,8314,8363,14002,5961,8041,7482,2747,4735,128,189,670,4,39,14,83,15,54,14
R42212,í∑çËåß,êºäCés,26275,13120,13155,25815,12745,13070,2836,1440,1396,13084,7103,5981,10182,4404,5778,5467,1995,3472,458,161,468,1,21,9,37,11,22,17
R42213,í∑çËåß,â_êÂés,41096,19378,21718,40625,19270,21355,4914,2501,2413,21437,10641,10796,14677,6197,8480,7880,2808,5072,423,243,609,4,36,22,84,31,55,27
R42214,í∑çËåß,ìÏìáå¥és,42330,19598,22732,42066,19558,22508,4735,2350,2385,20469,9983,10486,17109,7252,9857,9300,3466,5834,259,237,765,4,31,23,53,29,46,30
R42307,í∑çËåß,í∑ó^í¨,40780,19196,21584,40574,19115,21459,5932,3027,2905,23607,11256,12351,11105,4838,6267,5425,2130,3295,162,343,343,2,42,18,63,22,70,10
R42308,í∑çËåß,éûí√í¨,29339,14116,15223,29127,13988,15139,4532,2471,2061,16883,8197,8686,7859,3396,4463,3785,1482,2303,201,263,272,3,31,12,84,16,88,9
R42321,í∑çËåß,ìåîﬁãní¨,7721,3686,4035,7665,3660,4005,853,438,415,3855,1947,1908,2991,1288,1703,1589,590,999,42,29,121,1,7,4,14,6,8,3
R42322,í∑çËåß,êÏíIí¨,13377,6300,7077,13255,6257,6998,1723,892,831,7195,3497,3698,4411,1885,2526,2231,854,1377,98,103,167,1,10,6,29,10,26,5
R42323,í∑çËåß,îgç≤å©í¨,14291,6753,7538,14236,6733,7503,1968,1030,938,7676,3738,3938,4598,1957,2641,2315,847,1468,29,128,176,1,12,7,24,8,19,5
R42383,í∑çËåß,è¨ílâÍí¨,2288,1054,1234,2282,1052,1230,196,89,107,930,462,468,1162,503,659,621,224,397,6,10,57,0,2,1,2,1,1,1
R42391,í∑çËåß,ç≤ÅXí¨,13912,6591,7321,13854,6567,7287,2321,1212,1109,7650,3687,3963,3922,1679,2243,1820,687,1133,48,142,131,0,11,8,12,10,19,4
R42411,í∑çËåß,êVè„å‹ìáí¨,17503,8234,9269,17458,8207,9251,1573,814,759,8449,4273,4176,7478,3146,4332,4045,1425,2620,45,81,368,1,19,11,38,11,32,9
R43100,åFñ{åß,åFñ{és,738865,349115,389750,718502,338800,379702,99199,50625,48574,429187,207631,221556,191066,80083,110983,96800,36235,60565,5421,6101,7090,79,642,405,3313,740,2274,183
R43202,åFñ{åß,î™ë„és,123067,57298,65769,120072,56474,63598,14679,7487,7192,65046,31566,33480,42131,17647,24484,22619,8345,14274,2036,822,1721,8,121,63,347,92,244,56
R43203,åFñ{åß,êlãgés,31108,14363,16745,30761,14199,16562,3709,1893,1816,15261,7436,7825,11649,4748,6901,6330,2228,4102,175,201,514,7,38,22,142,37,118,13
R43204,åFñ{åß,çrîˆés,50832,23900,26932,50418,23703,26715,6383,3280,3103,26066,12844,13222,18248,7707,10541,9241,3445,5796,305,332,716,3,47,21,146,33,83,11
R43205,åFñ{åß,êÖñìés,23557,10913,12644,23485,10889,12596,2673,1408,1265,11219,5527,5692,9624,3946,5678,5307,1904,3403,66,134,379,5,24,10,107,17,70,11
R43206,åFñ{åß,ã ñºés,64292,30410,33882,63190,29776,33414,7960,4128,3832,34050,16728,17322,21983,9413,12570,11792,4402,7390,841,417,864,3,62,30,124,43,123,21
R43208,åFñ{åß,éRé≠és,49025,23000,26025,48591,22874,25717,5867,3011,2856,24416,12036,12380,18601,7875,10726,10057,3743,6314,354,330,813,5,42,23,104,33,72,22
R43210,åFñ{åß,ãeírés,46416,22076,24340,45671,21824,23847,6100,3117,2983,24328,12015,12313,15807,6853,8954,8377,3184,5193,591,322,663,4,44,20,73,25,80,21
R43211,åFñ{åß,âFìyés,36122,17272,18850,35681,17052,18629,4863,2480,2383,20084,9929,10155,10885,4687,6198,5842,2272,3570,194,261,417,0,20,14,42,20,66,13
R43212,åFñ{åß,è„ìVëêés,24563,11502,13061,24422,11452,12970,2541,1276,1265,11653,5775,5878,10321,4431,5890,5606,2116,3490,95,143,423,1,22,10,33,13,33,15
R43213,åFñ{åß,âFèÈés,57032,26991,30041,56446,26739,29707,7189,3695,3494,29603,14528,15075,19919,8567,11352,10619,4033,6586,459,353,787,7,43,28,132,38,107,24
R43214,åFñ{åß,à¢ëhés,24930,11763,13167,24495,11631,12864,2778,1426,1352,12035,6050,5985,10051,4250,5801,5596,2102,3494,394,138,374,3,20,8,57,13,48,12
R43215,åFñ{åß,ìVëêés,75783,35420,40363,75328,35225,40103,8436,4364,4072,35883,17789,18094,31011,13064,17947,16927,6163,10764,320,453,1403,11,73,40,196,60,142,48
R43216,åFñ{åß,çáéués,61772,29702,32070,61404,29522,31882,11505,5903,5602,35085,17206,17879,14960,6511,8449,7137,2795,4342,245,635,503,4,40,22,117,38,110,24
R43348,åFñ{åß,î¸ó¢í¨,9392,4361,5031,9329,4336,4993,778,382,396,4198,2119,2079,4416,1860,2556,2577,899,1678,63,36,190,2,5,4,16,5,14,4
R43364,åFñ{åß,ã ìåí¨,5045,2399,2646,5019,2382,2637,704,366,338,2508,1255,1253,1833,778,1055,1020,381,639,26,33,60,0,2,2,3,2,1,2
R43367,åFñ{åß,ìÏä÷í¨,8979,4282,4697,8831,4185,4646,951,476,475,4484,2261,2223,3529,1537,1992,1931,735,1196,147,46,152,0,5,5,3,5,3,2
R43368,åFñ{åß,í∑èFí¨,15372,7668,7704,14777,7190,7587,1843,951,892,8024,4218,3806,5492,2487,3005,2578,1002,1576,592,94,180,1,8,6,15,9,15,4
R43369,åFñ{åß,òaêÖí¨,9342,4397,4945,9303,4374,4929,950,489,461,4410,2237,2173,3961,1653,2308,2290,831,1459,39,49,189,1,6,4,9,4,6,4
R43403,åFñ{åß,ëÂí√í¨,35187,17449,17738,34522,17135,17387,5980,3118,2862,21234,10843,10391,7632,3264,4368,3691,1390,2301,383,323,298,1,23,11,32,17,49,10
R43404,åFñ{åß,ãeózí¨,43337,21220,22117,42337,20777,21560,7429,3759,3670,26215,13189,13026,9043,3979,5064,4233,1693,2540,389,475,265,4,32,22,127,28,85,15
R43423,åFñ{åß,ìÏè¨çëí¨,3750,1781,1969,3679,1745,1934,431,214,217,1806,919,887,1511,647,864,801,280,521,71,27,65,0,2,1,2,1,1,3
R43424,åFñ{åß,è¨çëí¨,6590,3135,3455,6549,3132,3417,699,364,335,3106,1595,1511,2775,1169,1606,1498,539,959,41,39,95,1,2,3,10,5,12,3
R43425,åFñ{åß,éYéRë∫,1382,714,668,1355,695,660,145,77,68,645,357,288,592,280,312,347,146,201,27,6,31,0,2,0,1,0,0,1
R43428,åFñ{åß,çÇêXí¨,5789,2788,3001,5727,2768,2959,628,335,293,2633,1350,1283,2503,1091,1412,1331,502,829,62,32,101,0,5,2,5,5,9,3
R43432,åFñ{åß,êºå¥ë∫,6426,3109,3317,6339,3085,3254,900,471,429,3496,1717,1779,2026,917,1109,955,369,586,87,42,76,0,4,2,2,3,4,2
R43433,åFñ{åß,ìÏà¢ëhë∫,9836,4796,5040,9682,4702,4980,1005,543,462,4551,2331,2220,4201,1872,2329,2171,832,1339,93,57,143,1,8,3,14,3,12,3
R43441,åFñ{åß,å‰ëDí¨,16303,7762,8541,16226,7730,8496,2239,1138,1101,8275,4036,4239,5663,2518,3145,2819,1119,1700,71,117,202,0,11,7,20,11,21,7
R43442,åFñ{åß,â√ìáí¨,9547,4584,4963,9443,4511,4932,1707,839,868,5299,2662,2637,2531,1074,1457,1375,493,882,104,95,106,2,12,6,25,12,39,5
R43443,åFñ{åß,âvèÈí¨,32510,15602,16908,32304,15513,16791,5144,2635,2509,17502,8526,8976,9742,4368,5374,4862,1964,2898,133,302,327,2,19,6,40,12,46,13
R43444,åFñ{åß,çbç≤í¨,10132,4813,5319,10065,4765,5300,1277,652,625,4863,2452,2411,3987,1705,2282,2178,813,1365,59,50,169,2,5,3,18,4,16,5
R43447,åFñ{åß,éRìsí¨,13503,6439,7064,13399,6389,7010,1241,625,616,5455,2824,2631,6771,2977,3794,3833,1417,2416,103,72,290,4,12,5,18,7,26,10
R43468,åFñ{åß,ïXêÏí¨,11094,5083,6011,10924,5068,5856,1206,619,587,5321,2562,2759,4298,1780,2518,2302,818,1484,155,51,205,1,9,5,11,6,14,6
R43482,åFñ{åß,à∞ñkí¨,15681,7370,8311,15650,7362,8288,1619,835,784,7030,3537,3493,7025,2994,4031,3948,1500,2448,31,84,301,3,15,5,31,12,22,8
R43484,åFñ{åß,í√ìﬁñÿí¨,4254,1993,2261,4247,1990,2257,460,231,229,1984,992,992,1790,759,1031,1033,366,667,7,26,86,0,4,1,2,1,1,2
R43501,åFñ{åß,ã—í¨,10288,4891,5397,10233,4861,5372,1529,778,751,5330,2647,2683,3420,1459,1961,1676,628,1048,49,89,130,0,9,4,8,4,7,6
R43505,åFñ{åß,ëΩó«ñÿí¨,9076,4263,4813,8994,4231,4763,1026,514,512,4130,2081,2049,3879,1642,2237,2151,794,1357,60,41,166,1,8,4,28,7,26,5
R43506,åFñ{åß,ìíëOí¨,3627,1700,1927,3622,1698,1924,391,203,188,1635,835,800,1601,662,939,909,327,582,5,14,76,0,2,2,2,2,5,2
R43507,åFñ{åß,êÖè„ë∫,2033,938,1095,2026,937,1089,264,141,123,867,443,424,902,354,548,530,166,364,7,14,30,0,3,1,1,1,1,2
R43510,åFñ{åß,ëäó«ë∫,4070,1929,2141,4055,1919,2136,437,223,214,1879,959,920,1754,747,1007,949,357,592,15,19,72,0,3,0,4,0,3,3
R43511,åFñ{åß,å‹ñÿë∫,931,447,484,928,447,481,72,34,38,409,221,188,446,191,255,266,92,174,3,2,15,0,1,0,0,0,0,1
R43512,åFñ{åß,éRç]ë∫,3238,1498,1740,3233,1497,1736,513,258,255,1520,725,795,1168,497,671,611,211,400,5,20,40,0,0,0,1,0,0,3
R43513,åFñ{åß,ãÖñÅë∫,2433,1174,1259,2432,1174,1258,245,128,117,1094,560,534,1087,483,604,557,204,353,1,12,95,0,1,1,1,0,0,2
R43514,åFñ{åß,Ç†Ç≥Ç¨ÇËí¨,14676,6783,7893,14463,6761,7702,1936,967,969,7082,3419,3663,5633,2379,3254,3039,1124,1915,203,74,225,1,11,5,11,6,17,10
R43531,åFñ{åß,óËñkí¨,7114,3388,3726,7046,3381,3665,735,381,354,3297,1717,1580,3071,1282,1789,1749,609,1140,64,28,109,3,6,2,22,3,11,6
R44201,ëÂï™åß,ëÂï™és,475614,228421,247193,465298,223082,242216,62944,32030,30914,271307,133532,137775,129289,55740,73549,62917,24713,38204,2661,3737,4347,41,380,228,1336,318,1061,114
R44202,ëÂï™åß,ï ï{és,115321,52398,62923,109278,49613,59665,11840,6066,5774,59108,28125,30983,39018,15498,23520,21464,7716,13748,2431,642,1568,21,113,56,571,93,316,33
R44203,ëÂï™åß,íÜí√és,82863,40307,42556,79812,38562,41250,10962,5575,5387,45200,23334,21866,24828,10352,14476,12829,4685,8144,1329,675,1031,10,71,40,197,51,165,32
R44204,ëÂï™åß,ì˙ìcés,62657,29676,32981,62106,29463,32643,7768,3984,3784,32326,16177,16149,22379,9428,12951,11802,4369,7433,412,415,996,14,52,36,137,40,125,23
R44205,ëÂï™åß,ç≤îåés,66851,30885,35966,66163,30522,35641,6959,3521,3438,31984,15764,16220,27348,11242,16106,14961,5426,9535,305,366,1072,7,57,31,149,39,135,19
R44206,ëÂï™åß,âPãnés,36158,17093,19065,35810,16847,18963,3741,1957,1784,17485,8807,8678,14828,6262,8566,8043,3019,5024,313,168,564,4,30,16,61,25,64,10
R44207,ëÂï™åß,í√ãvå©és,16100,7499,8601,16057,7482,8575,1420,710,710,7430,3711,3719,7238,3071,4167,3900,1433,2467,34,58,305,1,16,10,26,10,23,3
R44208,ëÂï™åß,í|ìcés,20332,9506,10826,20081,9449,10632,1810,942,868,8675,4379,4296,9808,4158,5650,5740,2085,3655,239,95,414,2,23,7,40,9,24,8
R44209,ëÂï™åß,ñLå„çÇìcés,22112,10498,11614,21455,10319,11136,2432,1295,1137,11010,5517,5493,8551,3595,4956,4738,1733,3005,615,148,376,2,15,13,33,19,33,6
R44210,ëÂï™åß,ãnízés,27999,13437,14562,27502,13198,14304,2943,1517,1426,13487,6867,6620,10378,4425,5953,5712,2119,3593,162,154,422,2,24,8,36,12,44,9
R44211,ëÂï™åß,âFç≤és,52771,24882,27889,51881,24520,27361,6164,3121,3043,26878,13409,13469,19292,8129,11163,10269,3739,6530,586,284,845,8,42,27,107,28,87,29
R44212,ëÂï™åß,ñLå„ëÂñÏés,33695,15699,17996,33413,15607,17806,3364,1721,1643,15270,7582,7688,14895,6299,8596,8566,3193,5373,209,146,673,3,31,16,71,21,68,12
R44213,ëÂï™åß,óRïzés,32772,15599,17173,32254,15385,16869,4161,2171,1990,17206,8551,8655,11195,4758,6437,5936,2239,3697,324,244,489,4,27,11,502,28,91,9
R44214,ëÂï™åß,çëìåés,26232,12504,13728,25802,12353,13449,2325,1186,1139,12383,6356,6027,11309,4855,6454,6472,2480,3992,238,111,550,3,21,13,42,15,37,11
R44322,ëÂï™åß,ïPìáë∫,1725,804,921,1722,802,920,133,76,57,650,330,320,942,398,544,495,186,309,3,7,37,0,1,0,3,1,0,1
R44341,ëÂï™åß,ì˙èoí¨,27723,13230,14493,27417,13066,14351,3803,1954,1849,15187,7470,7717,8510,3668,4842,4416,1726,2690,121,203,336,3,17,11,38,14,26,8
R44461,ëÂï™åß,ã„èdí¨,8541,4036,4505,8452,3996,4456,897,459,438,3782,1938,1844,3857,1635,2222,2169,796,1373,86,39,164,0,6,4,5,6,3,2
R44462,ëÂï™åß,ãËéÏí¨,14386,6940,7446,14232,6890,7342,1606,818,788,7159,3730,3429,5527,2328,3199,2963,1103,1860,100,90,255,3,13,8,16,11,15,5
R45201,ã{çËåß,ã{çËés,401339,189342,211997,387494,181783,205711,53799,27377,26422,224620,107985,116635,110618,47051,63567,54527,20970,33557,2109,3190,4147,34,380,229,1616,346,1067,137
R45202,ã{çËåß,ìsèÈés,160640,75308,85332,158140,74381,83759,22179,11329,10850,86299,42006,44293,50665,21257,29408,26126,9627,16499,1396,1291,2205,24,128,68,368,111,324,66
R45203,ã{çËåß,âÑâ™és,118394,56100,62294,116548,55028,61520,14483,7459,7024,61670,30813,30857,40712,16875,23837,21348,7796,13552,445,780,1695,14,84,53,246,71,283,40
R45204,ã{çËåß,ì˙ìÏés,50848,23930,26918,50413,23648,26765,5974,3051,2923,25172,12546,12626,19600,8256,11344,10743,4018,6725,401,273,877,8,47,21,126,30,93,18
R45205,ã{çËåß,è¨ó—és,43670,20327,23343,43060,20157,22903,5409,2786,2623,21866,10601,11265,16228,6840,9388,8813,3281,5532,487,280,725,9,31,17,89,22,92,21
R45206,ã{çËåß,ì˙å¸és,59629,28372,31257,58997,28116,30881,8052,4113,3939,31701,15743,15958,19265,8203,11062,9767,3729,6038,348,439,820,5,46,22,103,36,115,22
R45207,ã{çËåß,ã¯ä‘és,16822,7876,8946,16649,7801,8848,1934,982,952,7565,3774,3791,7193,3037,4156,4017,1409,2608,73,89,313,2,18,4,40,7,30,12
R45208,ã{çËåß,êºìsés,28610,13423,15187,28251,13283,14968,3287,1685,1602,14167,6962,7205,10826,4622,6204,5777,2215,3562,88,183,462,5,25,14,50,16,35,19
R45209,ã{çËåß,Ç¶Ç—ÇÃés,17638,8339,9299,17490,8311,9179,1924,959,965,8188,4117,4071,7471,3229,4242,4060,1521,2539,133,79,348,3,18,10,30,14,26,8
R45341,ã{çËåß,éOå“í¨,25591,11932,13659,25388,11846,13542,4410,2281,2129,13875,6541,7334,7248,3070,4178,3651,1340,2311,153,223,266,0,14,7,24,9,26,12
R45361,ã{çËåß,çÇå¥í¨,8639,4127,4512,8571,4084,4487,932,490,442,4050,2018,2032,3609,1584,2025,1945,730,1215,20,48,158,1,7,3,8,4,12,5
R45382,ã{çËåß,çëïxí¨,18398,8609,9789,18268,8538,9730,2106,1040,1066,9411,4617,4794,6854,2935,3919,3512,1335,2177,130,105,288,2,13,5,23,9,20,9
R45383,ã{çËåß,àªí¨,6934,3267,3667,6917,3260,3657,974,502,472,3406,1652,1754,2554,1113,1441,1313,538,775,17,43,97,0,4,2,5,2,8,3
R45401,ã{çËåß,çÇìÁí¨,19922,9497,10425,19829,9450,10379,2614,1336,1278,10717,5338,5379,6500,2752,3748,3270,1245,2025,58,139,249,2,20,11,30,16,36,7
R45402,ã{çËåß,êVïxí¨,16564,8096,8468,16406,8028,8378,2212,1150,1062,9093,4626,4467,5255,2317,2938,2622,1051,1571,154,122,193,0,12,4,9,6,16,10
R45403,ã{çËåß,êºïƒó«ë∫,1000,492,508,999,491,508,136,82,54,427,231,196,437,179,258,267,96,171,1,10,18,0,3,1,2,1,1,1
R45404,ã{çËåß,ñÿèÈí¨,4895,2250,2645,4889,2247,2642,761,361,400,2312,1115,1197,1822,774,1048,962,363,599,6,33,85,0,5,2,1,2,1,3
R45405,ã{çËåß,êÏìÏí¨,15194,7147,8047,14948,7111,7837,1946,1007,939,7807,3769,4038,5428,2361,3067,2742,1066,1676,237,81,215,2,11,3,24,3,15,6
R45406,ã{çËåß,ìsî_í¨,9906,4677,5229,9844,4652,5192,1246,611,635,4816,2416,2400,3838,1646,2192,1956,775,1181,61,61,159,1,5,4,11,4,11,5
R45421,ã{çËåß,ñÂêÏí¨,17379,8276,9103,17276,8228,9048,2367,1212,1155,9045,4515,4530,5946,2534,3412,3030,1160,1870,95,112,244,3,5,7,35,8,34,7
R45429,ã{çËåß,èîíÀë∫,1486,725,761,1484,724,760,150,88,62,657,335,322,678,302,376,405,152,253,2,7,30,0,2,1,2,1,2,0
R45430,ã{çËåß,í≈ótë∫,2503,1268,1235,2499,1268,1231,298,160,138,1063,593,470,1142,515,627,672,258,414,4,13,53,1,2,1,3,1,0,0
R45431,ã{çËåß,î¸ãΩí¨,4826,2337,2489,4814,2336,2478,422,228,194,1915,1009,906,2489,1100,1389,1433,562,871,12,17,126,1,6,2,7,2,5,2
R45441,ã{çËåß,çÇêÁï‰í¨,11642,5604,6038,11602,5586,6016,1326,695,631,5286,2701,2585,5017,2198,2819,2734,1034,1700,32,66,212,1,5,6,21,8,16,6
R45442,ã{çËåß,ì˙îVâeí¨,3635,1745,1890,3632,1744,1888,378,173,205,1600,851,749,1657,721,936,965,355,610,3,22,84,1,2,1,4,1,2,2
R45443,ã{çËåß,å‹Éñê£í¨,3472,1697,1775,3463,1693,1770,454,238,216,1527,790,737,1491,669,822,827,319,508,9,14,71,1,1,1,2,1,2,2
R46201,é≠éôìáåß,é≠éôìáés,593128,276130,316998,563096,260548,302548,75680,39072,36608,321038,149460,171578,158804,67201,91603,78289,29420,48869,2432,4788,6116,75,528,370,2692,767,1617,166
R46203,é≠éôìáåß,é≠âÆés,101096,48390,52706,99258,47493,51765,15134,7726,7408,54584,26817,27767,29928,12960,16968,15549,5944,9605,541,908,1261,11,70,46,240,65,202,41
R46204,é≠éôìáåß,ñççËés,20033,9178,10855,19631,9127,10504,2031,1050,981,9758,4662,5096,8192,3436,4756,4226,1523,2703,373,80,357,7,14,11,54,14,33,7
R46206,é≠éôìáåß,à¢ãvç™és,19270,9064,10206,19140,9025,10115,1967,1030,937,9177,4600,4577,8050,3393,4657,4663,1715,2948,108,96,351,2,16,8,48,10,35,8
R46208,é≠éôìáåß,èoêÖés,51994,24237,27757,50854,23923,26931,6822,3517,3305,27139,12985,14154,17372,7393,9979,9060,3406,5654,763,363,710,3,41,23,91,32,91,17
R46210,é≠éôìáåß,éwèhés,39011,18107,20904,38589,17996,20593,4554,2371,2183,18928,9007,9921,15411,6656,8755,8061,3046,5015,337,229,632,7,36,21,110,27,67,16
R46213,é≠éôìáåß,êºîVï\és,14708,7049,7659,14630,7023,7607,1820,937,883,7284,3734,3550,5598,2372,3226,2973,1083,1890,77,88,225,1,6,4,30,8,22,8
R46214,é≠éôìáåß,êÇêÖés,13819,6397,7422,13552,6361,7191,1270,651,619,6482,3120,3362,5898,2530,3368,3160,1151,2009,264,65,302,1,8,6,27,6,30,7
R46215,é≠éôìáåß,éFñÄêÏì‡és,92403,44570,47833,91176,44010,47166,12750,6516,6234,49189,24862,24327,29697,12741,16956,15630,5739,9891,472,713,1308,9,99,39,225,67,175,33
R46216,é≠éôìáåß,ì˙íués,47153,22167,24986,46801,21981,24820,6134,3201,2933,24323,11755,12568,16626,7170,9456,8734,3219,5515,315,317,693,8,40,21,99,31,88,21
R46217,é≠éôìáåß,ë]âóés,33310,15556,17754,32919,15473,17446,3654,1868,1786,15819,7754,8065,13797,5906,7891,7605,2790,4815,362,165,673,6,23,11,45,17,49,14
R46218,é≠éôìáåß,ñ∂ìáés,123135,58976,64159,120880,57986,62894,17537,8931,8606,69521,34205,35316,33905,14780,19125,16980,6401,10579,655,980,1447,14,97,59,218,74,192,46
R46219,é≠éôìáåß,Ç¢ÇøÇ´ã¯ñÿñÏés,27490,12742,14748,27268,12659,14609,3165,1610,1555,14107,6744,7363,10172,4362,5810,5378,2036,3342,206,163,422,5,27,16,56,16,46,9
R46220,é≠éôìáåß,ìÏÇ≥Ç¬Ç‹és,32887,15107,17780,32645,15047,17598,3656,1898,1758,15698,7414,8284,13016,5569,7447,7100,2570,4530,217,185,588,6,35,14,74,17,72,15
R46221,é≠éôìáåß,éuïzéués,29329,13998,15331,28832,13794,15038,4016,2053,1963,14579,7175,7404,10513,4629,5884,5578,2131,3447,328,193,468,2,23,13,37,19,35,18
R46222,é≠éôìáåß,âÇî¸és,41390,19778,21612,41234,19707,21527,5685,2917,2768,22168,11147,11021,13441,5657,7784,6821,2457,4364,102,292,587,6,35,16,129,28,97,11
R46223,é≠éôìáåß,ìÏã„èBés,33080,15447,17633,32705,15308,17397,3684,1867,1817,16138,7931,8207,13247,5640,7607,7319,2615,4704,369,191,623,4,31,18,61,21,45,19
R46224,é≠éôìáåß,à…ç≤és,24453,11327,13126,24304,11281,13023,2754,1427,1327,11490,5651,5839,10166,4223,5943,5664,2030,3634,120,159,527,5,22,8,63,9,52,13
R46225,é≠éôìáåß,à¶ó«és,76348,35748,40600,75733,35439,40294,10978,5609,5369,40949,19520,21429,23946,10315,13631,12196,4713,7483,351,586,952,9,63,33,173,45,141,26
R46303,é≠éôìáåß,éOìáë∫,405,191,214,402,189,213,95,45,50,203,104,99,107,42,65,65,21,44,3,4,1,0,4,0,0,0,0,0
R46304,é≠éôìáåß,è\ìáë∫,740,412,328,731,404,327,143,77,66,393,232,161,204,103,101,101,38,63,9,9,9,0,7,0,0,0,0,0
R46392,é≠éôìáåß,Ç≥Ç¬Ç‹í¨,20243,9439,10804,19827,9325,10502,2199,1137,1062,9553,4758,4795,8447,3512,4935,4800,1683,3117,403,90,372,3,20,8,44,13,38,12
R46404,é≠éôìáåß,í∑ìáí¨,9705,4706,4999,9627,4676,4951,1384,725,659,4768,2451,2317,3545,1525,2020,1878,690,1188,78,77,168,0,9,1,6,2,5,6
R46452,é≠éôìáåß,óNêÖí¨,9119,4403,4716,9031,4386,4645,890,470,420,4201,2225,1976,4026,1706,2320,2288,817,1471,88,48,194,1,8,3,10,3,12,4
R46468,é≠éôìáåß,ëÂçËí¨,12385,5868,6517,12082,5817,6265,1417,741,676,6082,2976,3106,4869,2139,2730,2537,999,1538,303,60,205,0,6,5,6,6,6,7
R46482,é≠éôìáåß,ìåã¯ó«í¨,6237,2946,3291,6110,2922,3188,878,479,399,3066,1494,1572,2287,970,1317,1323,483,840,126,35,128,0,8,2,5,2,6,3
R46490,é≠éôìáåß,ã—ç]í¨,6944,3259,3685,6875,3246,3629,699,330,369,3011,1520,1491,3233,1408,1825,1914,704,1210,69,31,164,1,10,4,12,5,15,5
R46491,é≠éôìáåß,ìÏëÂã˜í¨,6481,3078,3403,6458,3073,3385,583,294,289,2701,1419,1282,3197,1365,1832,1927,715,1212,23,27,190,0,8,2,4,4,5,3
R46492,é≠éôìáåß,äÃïtí¨,14227,6982,7245,14159,6948,7211,1654,916,738,6687,3476,3211,5886,2590,3296,3349,1295,2054,68,79,301,2,9,6,16,6,18,7
R46501,é≠éôìáåß,íÜéÌéqí¨,7539,3549,3990,7519,3545,3974,951,468,483,3618,1853,1765,2967,1226,1741,1712,602,1110,19,53,122,0,5,3,3,6,6,1
R46502,é≠éôìáåß,ìÏéÌéqí¨,5445,2726,2719,5432,2720,2712,725,380,345,2751,1497,1254,1963,843,1120,1091,400,691,13,24,93,1,3,1,4,1,6,2
R46505,é≠éôìáåß,âÆãvìáí¨,11858,5800,6058,11754,5770,5984,1607,804,803,5926,3026,2900,4315,1963,2352,2092,802,1290,101,81,202,1,10,3,12,5,11,6
R46523,é≠éôìáåß,ëÂòaë∫,1364,673,691,1363,672,691,141,84,57,636,338,298,586,250,336,338,120,218,1,9,33,0,3,0,0,0,2,0
R46524,é≠éôìáåß,âFåüë∫,1621,792,829,1617,788,829,203,101,102,718,370,348,700,321,379,360,140,220,4,12,31,0,3,0,1,0,1,1
R46525,é≠éôìáåß,ê£åÀì‡í¨,8546,4215,4331,8510,4191,4319,1043,526,517,4227,2287,1940,3251,1387,1864,1745,616,1129,14,68,152,2,9,4,12,4,11,1
R46527,é≠éôìáåß,ó¥ãΩí¨,5817,2812,3005,5798,2800,2998,918,484,434,2990,1471,1519,1906,854,1052,1027,399,628,17,49,83,0,8,2,3,2,2,3
R46529,é≠éôìáåß,äÏäEí¨,6629,3255,3374,6590,3250,3340,824,411,413,3118,1656,1462,2663,1178,1485,1405,518,887,38,39,109,1,3,3,4,3,3,2
R46530,é≠éôìáåß,ìøîVìáí¨,10147,4967,5180,10105,4961,5144,1533,795,738,5246,2662,2584,3368,1510,1858,1763,671,1092,41,92,159,2,4,2,21,4,15,3
R46531,é≠éôìáåß,ìVèÈí¨,5517,2788,2729,5487,2787,2700,769,409,360,2701,1461,1240,2047,918,1129,1118,426,692,30,33,112,0,3,1,2,1,2,3
R46532,é≠éôìáåß,à…êÂí¨,6139,3074,3065,6115,3067,3048,985,491,494,2831,1516,1315,2323,1067,1256,1314,512,802,24,48,132,0,3,2,1,4,0,4
R46533,é≠éôìáåß,òaîëí¨,6246,3081,3165,6138,3047,3091,904,468,436,3075,1609,1466,2267,1004,1263,1126,419,707,108,51,130,0,4,2,4,2,7,4
R46534,é≠éôìáåß,ímñºí¨,5750,2862,2888,5683,2857,2826,798,390,408,2745,1430,1315,2163,1024,1139,1103,450,653,53,25,93,1,4,4,7,4,2,3
R46535,é≠éôìáåß,ó^ò_í¨,5115,2460,2655,5103,2457,2646,747,366,381,2576,1317,1259,1792,777,1015,992,369,623,12,33,76,1,3,2,4,2,4,4
R47201,â´ìÍåß,ìﬂîeés,317625,154042,163583,304596,147035,157561,46166,23507,22659,189536,94267,95269,72287,30775,41512,35654,13470,22184,4575,2737,2789,15,274,180,820,243,676,137
R47205,â´ìÍåß,ãXñÏòpés,100125,48826,51299,94625,45803,48822,16651,8398,8253,60492,29913,30579,18925,8259,10666,8969,3552,5417,1572,1183,617,3,50,42,97,52,103,32
R47207,â´ìÍåß,êŒä_és,47637,24001,23636,46604,23409,23195,8162,4158,4004,28172,14429,13743,10482,4863,5619,4711,1877,2834,473,480,417,3,29,19,95,28,70,27
R47208,â´ìÍåß,âYìYés,115690,55977,59713,113147,54713,58434,19722,10035,9687,71286,35105,36181,23180,10209,12971,11025,4408,6617,1135,1240,796,7,80,55,322,99,244,39
R47209,â´ìÍåß,ñºåÏés,63554,31606,31948,61504,30516,30988,10536,5398,5138,37252,18741,18511,13901,6430,7471,6502,2699,3803,529,668,537,6,45,25,177,34,101,35
R47210,â´ìÍåß,éÖñûés,61007,30707,30300,59864,30031,29833,10960,5559,5401,36069,18523,17546,13522,6394,7128,6045,2518,3527,803,685,542,2,28,19,85,23,74,28
R47211,â´ìÍåß,â´ìÍés,142752,69489,73263,136475,65838,70637,23829,12183,11646,85673,42248,43425,28854,12633,16221,13721,5312,8409,1993,1501,1135,7,77,58,382,79,263,57
R47212,â´ìÍåß,ñLå©èÈés,64612,31465,33147,63684,31035,32649,12526,6347,6179,38759,19216,19543,12729,5657,7072,5924,2356,3568,367,767,397,4,38,21,255,24,133,24
R47213,â´ìÍåß,Ç§ÇÈÇ‹és,125303,63049,62254,123914,62084,61830,21184,10930,10254,75679,38886,36793,28050,12985,15065,13196,5373,7823,1357,1339,1152,3,48,38,292,61,128,46
R47214,â´ìÍåß,ã{å√ìáés,52931,26481,26450,51750,26000,25750,8402,4350,4052,29513,15249,14264,14079,6410,7669,6904,2820,4084,464,524,697,4,37,24,95,34,57,30
R47215,â´ìÍåß,ìÏèÈés,44043,22164,21879,43646,21932,21714,7734,3974,3760,24757,12721,12036,11409,5383,6026,5623,2346,3277,257,447,440,1,17,12,23,14,27,22
R47301,â´ìÍåß,çëì™ë∫,4517,2317,2200,4485,2297,2188,587,301,286,2380,1253,1127,1550,763,787,775,316,459,32,31,74,0,3,2,2,2,3,1
R47302,â´ìÍåß,ëÂãXñ°ë∫,3092,1640,1452,3068,1628,1440,351,173,178,1594,866,728,1146,600,546,570,244,326,23,19,51,0,3,1,1,2,1,1
R47303,â´ìÍåß,ìåë∫,1598,884,714,1587,875,712,198,109,89,813,466,347,587,309,278,269,127,142,11,11,24,0,1,1,2,0,0,1
R47306,â´ìÍåß,ç°ãAêmë∫,8894,4466,4428,8848,4441,4407,1335,665,670,4538,2332,2206,3019,1469,1550,1534,614,920,44,72,130,1,2,3,6,3,5,4
R47308,â´ìÍåß,ñ{ïîí¨,12530,6337,6193,12348,6245,6103,1796,906,890,6547,3353,3194,4107,2035,2072,1918,784,1134,133,86,179,1,3,4,18,4,10,6
R47311,â´ìÍåß,â∂î[ë∫,10869,5497,5372,10121,5096,5025,1585,765,820,6663,3475,3188,2621,1257,1364,1240,497,743,743,58,94,0,4,1,2,1,5,5
R47313,â´ìÍåß,ãXñÏç¿ë∫,5833,2907,2926,5789,2873,2916,1157,569,588,3179,1653,1526,1491,681,810,724,282,442,43,76,73,1,1,2,8,1,2,3
R47314,â´ìÍåß,ã‡ïêí¨,10806,5371,5435,10701,5309,5392,1874,946,928,5920,3109,2811,3006,1311,1695,1580,586,994,100,114,134,1,7,3,26,2,12,7
R47315,â´ìÍåß,à…ç]ë∫,4118,2074,2044,4092,2066,2026,623,328,295,2071,1094,977,1424,652,772,721,278,443,26,34,44,0,2,1,2,1,4,2
R47324,â´ìÍåß,ì«íJë∫,41206,20242,20964,40338,19757,20581,7073,3585,3488,24950,12364,12586,9050,4225,4825,4323,1811,2512,736,376,317,0,17,11,13,16,20,12
R47325,â´ìÍåß,â√éËî[í¨,13521,6561,6960,13354,6465,6889,2307,1168,1139,7862,3929,3933,3273,1414,1859,1756,672,1084,97,128,146,1,5,5,9,10,13,4
R47326,â´ìÍåß,ñkíJí¨,28201,13483,14718,26731,12762,13969,4780,2434,2346,16975,8186,8789,5765,2572,3193,2807,1107,1700,787,286,213,2,12,17,29,25,19,10
R47327,â´ìÍåß,ñkíÜèÈë∫,17969,8667,9302,17453,8331,9122,2973,1474,1499,10528,5156,5372,4294,1925,2369,2247,893,1354,383,158,123,3,6,5,123,7,65,6
R47328,â´ìÍåß,íÜèÈë∫,22157,11036,11121,21274,10551,10723,3865,1966,1899,13021,6590,6431,4113,1868,2245,1985,792,1193,329,248,154,2,9,7,107,8,32,9
R47329,â´ìÍåß,êºå¥í¨,34984,17647,17337,34058,17033,17025,5637,2892,2745,21351,10956,10395,7514,3518,3996,3314,1444,1870,507,268,219,2,19,10,464,41,126,10
R47348,â´ìÍåß,ó^ìﬂå¥í¨,19695,9554,10141,19282,9367,9915,3750,1945,1805,11665,5699,5966,3902,1759,2143,1764,709,1055,109,277,128,1,8,6,30,11,34,9
R47350,â´ìÍåß,ìÏïóå¥í¨,40440,19825,20615,39978,19574,20404,8161,4162,3999,24111,11898,12213,7862,3628,4234,3684,1559,2125,221,581,261,5,28,16,298,34,145,17
R47353,â´ìÍåß,ìnâ√ï~ë∫,718,387,331,712,383,329,138,74,64,434,235,199,146,78,68,73,29,44,6,10,3,0,1,1,1,1,0,0
R47354,â´ìÍåß,ç¿ä‘ñ°ë∫,892,486,406,877,476,401,160,94,66,545,292,253,187,100,87,79,31,48,15,8,10,0,2,0,2,0,0,0
R47355,â´ìÍåß,àæçëë∫,683,384,299,681,384,297,82,38,44,346,205,141,248,138,110,133,55,78,2,1,11,0,2,0,1,0,0,0
R47356,â´ìÍåß,ìnñºäÏë∫,346,206,140,344,205,139,29,20,9,174,111,63,143,75,68,77,34,43,2,1,5,0,1,1,1,1,0,0
R47357,â´ìÍåß,ìÏëÂìåë∫,1285,744,541,1254,732,522,202,98,104,767,468,299,316,178,138,162,80,82,31,7,5,0,1,1,1,0,1,0
R47358,â´ìÍåß,ñkëÂìåë∫,590,367,223,585,364,221,98,58,40,365,230,135,127,79,48,49,23,26,5,3,1,0,1,1,0,1,0,0
R47359,â´ìÍåß,à…ïΩâÆë∫,1126,607,519,1118,606,512,195,94,101,598,334,264,333,179,154,162,69,93,8,7,12,0,1,1,1,1,0,1
R47360,â´ìÍåß,à…ê•ñºë∫,1322,718,604,1299,705,594,207,102,105,707,414,293,408,202,206,201,83,118,23,7,30,0,2,1,1,1,0,1
R47361,â´ìÍåß,ãvïƒìáí¨,7192,3823,3369,7152,3802,3350,1075,568,507,3965,2172,1793,2145,1079,1066,1085,465,620,35,70,107,1,3,1,5,1,12,4
R47362,â´ìÍåß,î™èdê£í¨,30941,15244,15697,30805,15148,15657,5977,3047,2930,17990,9003,8987,6925,3173,3752,3336,1342,1994,129,362,250,1,12,7,82,16,47,14
R47375,â´ìÍåß,ëΩó«ä‘ë∫,1058,575,483,1047,574,473,150,80,70,585,328,257,323,167,156,156,74,82,11,5,7,0,1,1,1,2,0,1
R47381,â´ìÍåß,í|ïxí¨,3942,2033,1909,3898,2013,1885,707,362,345,2308,1194,1114,905,463,442,416,168,248,26,53,47,0,7,3,6,2,0,0
R47382,â´ìÍåß,ó^ìﬂçëí¨,1676,923,753,1661,913,748,302,148,154,1014,598,416,360,177,183,145,63,82,15,15,19,0,3,1,2,0,0,1
